Branch,Product,Units Sold,Revenue,Cost,Profit,Date
Brothalle,Kässecroissant,654,20831,9550,11281,08.05.2021
Hulsberg,Bumi,664,19432,7898,11534,10.07.2021
Ostertor,Bumi,420,13941,8061,5880,07.10.2021
Neuekirchen,Knüsperbrötchen,441,17581,6070,11511,27.05.2021
Achim,Kässecroissant,609,20291,8110,12181,22.10.2021
Hulsberg,Bumi,409,17771,6559,11212,13.12.2021
Brothalle,Weltmeisterbrötchen,342,13504,8857,4647,16.11.2021
Ostertor,Nougasant,573,18068,6722,11346,19.02.2021
Ostertor,Bumi,446,12247,8470,3777,02.02.2021
Brothalle,Weltmeisterbrötchen,375,17825,8293,9532,04.08.2021
Brothalle,Bumi,462,17012,7868,9144,14.04.2021
Neuekirchen,Bumi,433,17348,8838,8510,11.10.2021
Ostertor,Nougasant,678,18399,6277,12122,22.10.2021
Brothalle,Knüsperbrötchen,613,20058,8819,11239,29.05.2021
Neuekirchen,Bumi,372,13176,9679,3497,03.02.2021
Habenshausen,Weltmeisterbrötchen,481,15058,7232,7826,07.06.2021
Habenshausen,Bumi,479,15413,9293,6120,28.01.2021
Ostertor,Kässecroissant,375,16871,9492,7379,19.07.2021
Hulsberg,Weltmeisterbrötchen,683,20050,7924,12126,08.10.2021
Hulsberg,Bumi,658,20301,9283,11018,13.02.2021
Hulsberg,Nougasant,491,17967,8400,9567,08.07.2021
Achim,Nougasant,582,18504,8818,9686,13.03.2021
Habenshausen,Knüsperbrötchen,435,17542,9706,7836,03.11.2021
Hulsberg,Bumi,315,12002,7767,4235,31.01.2021
Achim,Nougasant,351,12750,8294,4456,19.04.2021
Brothalle,Bumi,323,17366,8281,9085,27.07.2021
Hulsberg,Weltmeisterbrötchen,472,16656,8169,8487,14.03.2021
Neuekirchen,Kässecroissant,637,20094,9383,10711,15.10.2021
Neuekirchen,Nougasant,467,12946,6423,6523,01.03.2021
Achim,Weltmeisterbrötchen,684,20250,8738,11512,25.12.2021
Achim,Kässecroissant,321,15930,8819,7111,31.05.2021
Brothalle,Bumi,500,19929,9698,10231,27.08.2021
Hulsberg,Weltmeisterbrötchen,628,20432,8744,11688,24.07.2021
Habenshausen,Weltmeisterbrötchen,334,15589,8927,6662,25.01.2021
Neuekirchen,Kässecroissant,527,18902,7400,11502,15.01.2021
Brothalle,Bumi,351,16420,7458,8962,19.08.2021
Hulsberg,Bumi,342,12557,7819,4738,22.08.2021
Achim,Weltmeisterbrötchen,406,14857,8544,6313,08.02.2021
Achim,Bumi,498,15657,9255,6402,25.05.2021
Ostertor,Weltmeisterbrötchen,374,14475,8622,5853,16.11.2021
Ostertor,Nougasant,314,13003,9513,3490,31.05.2021
Brothalle,Bumi,355,12143,6664,5479,15.07.2021
Ostertor,Bumi,564,20507,7778,12729,10.04.2021
Neuekirchen,Weltmeisterbrötchen,439,16113,6343,9770,12.07.2021
Achim,Bumi,675,20678,7726,12952,09.01.2021
Brothalle,Weltmeisterbrötchen,370,14898,9147,5751,16.03.2021
Hulsberg,Nougasant,394,12034,7584,4450,06.01.2021
Neuekirchen,Weltmeisterbrötchen,479,15322,6234,9088,28.06.2021
Neuekirchen,Weltmeisterbrötchen,485,15851,6924,8927,24.10.2021
Brothalle,Weltmeisterbrötchen,345,16206,8811,7395,05.12.2021
Achim,Nougasant,387,14179,9019,5160,24.03.2021
Habenshausen,Dinkelmalzbrötchen,314,15691,7810,7881,04.08.2021
Achim,Weltmeisterbrötchen,623,20364,7345,13019,12.03.2021
Habenshausen,Nougasant,349,17452,9185,8267,15.03.2021
Neuekirchen,Knüsperbrötchen,485,14163,6342,7821,01.04.2021
Achim,Nougasant,359,17258,6794,10464,30.03.2021
Brothalle,Nougasant,602,18507,6683,11824,14.08.2021
Brothalle,Nougasant,462,12687,9750,2937,09.05.2021
Neuekirchen,Bumi,300,16818,9473,7345,20.06.2021
Ostertor,Nougasant,551,20136,8083,12053,30.07.2021
Hulsberg,Kässecroissant,303,15820,6804,9016,21.04.2021
Habenshausen,Bumi,601,19503,9424,10079,30.04.2021
Habenshausen,Nougasant,446,15523,9936,5587,27.01.2021
Hulsberg,Kässecroissant,364,13597,9270,4327,06.05.2021
Habenshausen,Knüsperbrötchen,343,17602,7006,10596,26.09.2021
Hulsberg,Bumi,312,13708,6691,7017,28.04.2021
Habenshausen,Bumi,406,14752,7924,6828,31.05.2021
Brothalle,Weltmeisterbrötchen,558,20336,9662,10674,10.09.2021
Brothalle,Weltmeisterbrötchen,393,13837,6520,7317,09.05.2021
Ostertor,Weltmeisterbrötchen,478,17593,7525,10068,31.03.2021
Neuekirchen,Bumi,354,15677,6775,8902,31.08.2021
Achim,Dinkelmalzbrötchen,484,16260,6410,9850,02.05.2021
Brothalle,Bumi,369,17007,7941,9066,21.10.2021
Achim,Weltmeisterbrötchen,629,20118,8499,11619,24.04.2021
Brothalle,Knüsperbrötchen,525,19343,8894,10449,02.07.2021
Hulsberg,Dinkelmalzbrötchen,305,17739,8448,9291,24.10.2021
Neuekirchen,Kässecroissant,521,18039,9660,8379,30.07.2021
Brothalle,Nougasant,334,17136,9527,7609,26.04.2021
Achim,Bumi,557,19705,7187,12518,27.02.2021
Achim,Knüsperbrötchen,577,18880,9721,9159,03.12.2021
Brothalle,Weltmeisterbrötchen,606,18933,9709,9224,28.05.2021
Brothalle,Nougasant,600,20406,8017,12389,04.06.2021
Achim,Bumi,547,18167,7980,10187,27.11.2021
Hulsberg,Nougasant,468,17752,9375,8377,29.12.2021
Neuekirchen,Kässecroissant,430,17651,7115,10536,24.01.2021
Hulsberg,Knüsperbrötchen,344,17969,6147,11822,06.01.2021
Hulsberg,Weltmeisterbrötchen,454,16510,7147,9363,08.06.2021
Hulsberg,Weltmeisterbrötchen,424,14766,8339,6427,10.02.2021
Ostertor,Weltmeisterbrötchen,424,14540,9378,5162,26.08.2021
Hulsberg,Bumi,371,15554,7744,7810,24.08.2021
Habenshausen,Bumi,318,16191,6646,9545,13.10.2021
Ostertor,Nougasant,561,20642,6662,13980,08.01.2021
Achim,Weltmeisterbrötchen,363,14464,9600,4864,16.12.2021
Brothalle,Nougasant,354,13915,9605,4310,20.06.2021
Habenshausen,Bumi,355,14985,7058,7927,04.03.2021
Hulsberg,Nougasant,446,14722,8283,6439,22.08.2021
Hulsberg,Nougasant,574,19534,9754,9780,27.08.2021
Brothalle,Bumi,333,12969,8768,4201,21.03.2021
Neuekirchen,Weltmeisterbrötchen,415,14075,9629,4446,25.08.2021
Hulsberg,Bumi,603,18491,6669,11822,18.12.2021
Habenshausen,Nougasant,559,19095,8774,10321,12.02.2021
Neuekirchen,Bumi,301,16811,8163,8648,15.08.2021
Achim,Nougasant,510,19282,9442,9840,26.02.2021
Ostertor,Bumi,640,20114,6001,14113,11.09.2021
Ostertor,Bumi,381,15007,8929,6078,14.02.2021
Ostertor,Nougasant,310,15730,9626,6104,14.01.2021
Brothalle,Bumi,390,15423,9762,5661,01.11.2021
Brothalle,Weltmeisterbrötchen,408,13249,6382,6867,11.07.2021
Ostertor,Dinkelmalzbrötchen,478,14446,9747,4699,18.11.2021
Brothalle,Nougasant,385,14422,7429,6993,20.05.2021
Hulsberg,Weltmeisterbrötchen,551,20612,7768,12844,19.03.2021
Hulsberg,Bumi,547,18493,6061,12432,24.07.2021
Achim,Nougasant,480,12013,7353,4660,08.11.2021
Hulsberg,Nougasant,531,20555,9673,10882,29.10.2021
Habenshausen,Kässecroissant,503,20831,6616,14215,26.11.2021
Brothalle,Dinkelmalzbrötchen,643,18716,9404,9312,01.05.2021
Ostertor,Nougasant,655,20977,7391,13586,09.10.2021
Habenshausen,Weltmeisterbrötchen,570,18235,9829,8406,23.04.2021
Brothalle,Weltmeisterbrötchen,586,18348,7005,11343,24.09.2021
Achim,Bumi,495,14568,9415,5153,14.09.2021
Neuekirchen,Weltmeisterbrötchen,582,18191,7171,11020,01.10.2021
Achim,Dinkelmalzbrötchen,333,15721,8162,7559,12.08.2021
Achim,Weltmeisterbrötchen,404,17195,9395,7800,16.06.2021
Ostertor,Nougasant,699,18077,7420,10657,24.12.2021
Habenshausen,Bumi,639,19035,9001,10034,01.10.2021
Habenshausen,Bumi,437,17487,8732,8755,13.01.2021
Ostertor,Bumi,387,13158,6269,6889,09.08.2021
Hulsberg,Knüsperbrötchen,449,15041,9144,5897,29.03.2021
Hulsberg,Bumi,398,12954,7222,5732,15.08.2021
Habenshausen,Kässecroissant,315,12965,6911,6054,21.07.2021
Hulsberg,Kässecroissant,523,18294,8599,9695,26.03.2021
Habenshausen,Weltmeisterbrötchen,651,19801,6234,13567,21.08.2021
Brothalle,Nougasant,498,16567,6931,9636,25.07.2021
Brothalle,Kässecroissant,491,17390,7527,9863,01.02.2021
Ostertor,Nougasant,607,20570,9014,11556,27.02.2021
Habenshausen,Bumi,395,16863,6524,10339,04.08.2021
Hulsberg,Nougasant,420,17624,8972,8652,08.07.2021
Hulsberg,Dinkelmalzbrötchen,455,17988,9671,8317,29.06.2021
Hulsberg,Nougasant,450,13414,6992,6422,23.11.2021
Achim,Nougasant,357,14847,6415,8432,14.10.2021
Hulsberg,Dinkelmalzbrötchen,348,13941,7627,6314,13.06.2021
Ostertor,Weltmeisterbrötchen,360,15664,6008,9656,04.08.2021
Achim,Nougasant,473,15291,8753,6538,11.08.2021
Ostertor,Weltmeisterbrötchen,425,13402,6732,6670,07.11.2021
Ostertor,Nougasant,633,19687,8821,10866,17.04.2021
Achim,Knüsperbrötchen,452,16177,6529,9648,31.10.2021
Neuekirchen,Weltmeisterbrötchen,346,14563,6154,8409,28.06.2021
Brothalle,Nougasant,526,18984,8312,10672,11.09.2021
Brothalle,Dinkelmalzbrötchen,586,18814,6120,12694,22.01.2021
Brothalle,Weltmeisterbrötchen,564,19265,9949,9316,14.08.2021
Hulsberg,Kässecroissant,475,12194,7766,4428,31.03.2021
Habenshausen,Knüsperbrötchen,661,20692,7850,12842,18.12.2021
Neuekirchen,Weltmeisterbrötchen,634,19583,8845,10738,12.11.2021
Neuekirchen,Nougasant,667,20823,7614,13209,16.04.2021
Neuekirchen,Dinkelmalzbrötchen,493,14982,6301,8681,27.04.2021
Ostertor,Weltmeisterbrötchen,335,13141,8375,4766,23.11.2021
Ostertor,Weltmeisterbrötchen,649,20559,6184,14375,03.07.2021
Neuekirchen,Kässecroissant,482,14598,6584,8014,06.06.2021
Hulsberg,Kässecroissant,307,13851,8339,5512,01.11.2021
Ostertor,Bumi,372,13704,7708,5996,31.01.2021
Achim,Dinkelmalzbrötchen,474,14968,6360,8608,26.09.2021
Neuekirchen,Nougasant,571,19663,6836,12827,31.12.2021
Achim,Bumi,374,17732,6622,11110,09.08.2021
Habenshausen,Bumi,339,15115,8409,6706,14.11.2021
Ostertor,Bumi,373,15399,9848,5551,17.05.2021
Brothalle,Bumi,389,17539,8214,9325,01.07.2021
Brothalle,Bumi,679,19894,8003,11891,14.08.2021
Habenshausen,Knüsperbrötchen,621,18993,9164,9829,12.06.2021
Neuekirchen,Bumi,577,18375,6332,12043,13.02.2021
Hulsberg,Bumi,461,16188,7758,8430,24.03.2021
Neuekirchen,Nougasant,685,19611,7714,11897,20.03.2021
Hulsberg,Weltmeisterbrötchen,500,15854,8011,7843,18.08.2021
Hulsberg,Bumi,486,15119,9363,5756,12.12.2021
Brothalle,Bumi,378,14147,8038,6109,29.08.2021
Hulsberg,Weltmeisterbrötchen,434,17921,6339,11582,03.01.2021
Brothalle,Bumi,364,13841,8354,5487,25.02.2021
Hulsberg,Weltmeisterbrötchen,441,16142,8654,7488,30.06.2021
Habenshausen,Bumi,564,20778,9758,11020,18.06.2021
Neuekirchen,Bumi,410,13910,6283,7627,14.01.2021
Ostertor,Bumi,544,20194,9925,10269,27.08.2021
Hulsberg,Kässecroissant,375,13660,7164,6496,22.06.2021
Brothalle,Nougasant,411,15222,7630,7592,07.01.2021
Brothalle,Kässecroissant,442,12109,6294,5815,03.08.2021
Ostertor,Nougasant,448,13798,9034,4764,09.06.2021
Ostertor,Knüsperbrötchen,492,17055,6604,10451,05.01.2021
Hulsberg,Weltmeisterbrötchen,474,16016,6203,9813,07.04.2021
Achim,Weltmeisterbrötchen,438,12543,8771,3772,16.11.2021
Hulsberg,Bumi,327,14438,7617,6821,25.01.2021
Brothalle,Weltmeisterbrötchen,450,13966,6657,7309,31.01.2021
Habenshausen,Dinkelmalzbrötchen,307,14763,7900,6863,30.08.2021
Habenshausen,Dinkelmalzbrötchen,694,18724,6598,12126,26.06.2021
Brothalle,Dinkelmalzbrötchen,472,13082,7588,5494,02.09.2021
Habenshausen,Weltmeisterbrötchen,313,14748,8881,5867,15.03.2021
Brothalle,Weltmeisterbrötchen,644,19413,6456,12957,23.01.2021
Achim,Nougasant,695,20189,7274,12915,10.12.2021
Ostertor,Nougasant,659,19708,7306,12402,17.07.2021
Neuekirchen,Dinkelmalzbrötchen,461,16455,8939,7516,10.05.2021
Achim,Weltmeisterbrötchen,668,20637,6355,14282,03.09.2021
Hulsberg,Weltmeisterbrötchen,387,12148,9062,3086,07.07.2021
Achim,Weltmeisterbrötchen,461,12936,8810,4126,26.10.2021
Hulsberg,Nougasant,328,17018,8524,8494,07.03.2021
Habenshausen,Nougasant,513,18693,7480,11213,24.07.2021
Neuekirchen,Nougasant,314,12332,6142,6190,20.06.2021
Achim,Nougasant,470,14346,9164,5182,29.07.2021
Achim,Bumi,626,20046,7570,12476,23.01.2021
Hulsberg,Knüsperbrötchen,333,17002,6368,10634,20.06.2021
Hulsberg,Kässecroissant,321,15078,6251,8827,10.01.2021
Habenshausen,Weltmeisterbrötchen,400,15544,8888,6656,02.02.2021
Achim,Nougasant,618,19735,9540,10195,05.03.2021
Hulsberg,Kässecroissant,317,17393,8041,9352,24.02.2021
Ostertor,Nougasant,332,15163,9031,6132,02.06.2021
Neuekirchen,Weltmeisterbrötchen,360,15808,8871,6937,14.06.2021
Hulsberg,Dinkelmalzbrötchen,628,20235,7388,12847,14.08.2021
Brothalle,Nougasant,412,14930,6488,8442,21.01.2021
Habenshausen,Weltmeisterbrötchen,476,16147,9868,6279,19.05.2021
Hulsberg,Weltmeisterbrötchen,379,12416,6691,5725,13.04.2021
Hulsberg,Nougasant,345,14033,6274,7759,18.11.2021
Habenshausen,Bumi,391,13414,9996,3418,05.04.2021
Hulsberg,Weltmeisterbrötchen,403,13701,7937,5764,22.09.2021
Hulsberg,Bumi,511,18864,7868,10996,05.06.2021
Brothalle,Nougasant,700,18414,6122,12292,30.04.2021
Habenshausen,Bumi,497,13697,6355,7342,16.06.2021
Achim,Nougasant,397,16204,7063,9141,19.01.2021
Ostertor,Kässecroissant,353,15181,8520,6661,31.01.2021
Ostertor,Knüsperbrötchen,477,15633,7096,8537,20.10.2021
Neuekirchen,Nougasant,402,17207,6663,10544,04.11.2021
Achim,Nougasant,339,16330,6215,10115,28.10.2021
Ostertor,Bumi,479,13592,7116,6476,31.05.2021
Achim,Bumi,461,14156,9632,4524,24.08.2021
Brothalle,Knüsperbrötchen,389,16652,7283,9369,24.06.2021
Achim,Nougasant,439,14873,7308,7565,01.03.2021
Habenshausen,Bumi,445,14303,9146,5157,02.08.2021
Habenshausen,Weltmeisterbrötchen,329,17367,7560,9807,11.05.2021
Brothalle,Bumi,462,12688,7036,5652,21.04.2021
Neuekirchen,Weltmeisterbrötchen,319,14566,6486,8080,15.06.2021
Ostertor,Weltmeisterbrötchen,359,12800,8594,4206,10.06.2021
Habenshausen,Weltmeisterbrötchen,444,13857,9161,4696,23.09.2021
Habenshausen,Weltmeisterbrötchen,393,14848,8857,5991,25.11.2021
Achim,Nougasant,529,20043,6660,13383,04.12.2021
Brothalle,Weltmeisterbrötchen,564,20362,7312,13050,06.03.2021
Ostertor,Dinkelmalzbrötchen,365,15975,8108,7867,14.11.2021
Ostertor,Nougasant,388,16528,9328,7200,18.10.2021
Hulsberg,Bumi,399,13831,9722,4109,15.07.2021
Brothalle,Nougasant,484,15927,8312,7615,30.09.2021
Brothalle,Nougasant,489,12837,7643,5194,31.10.2021
Achim,Weltmeisterbrötchen,386,16115,6840,9275,14.01.2021
Habenshausen,Dinkelmalzbrötchen,422,15256,7474,7782,04.08.2021
Ostertor,Kässecroissant,417,16496,6847,9649,01.12.2021
Habenshausen,Weltmeisterbrötchen,450,16526,9737,6789,22.08.2021
Brothalle,Weltmeisterbrötchen,611,19728,9635,10093,14.05.2021
Ostertor,Bumi,325,13163,8607,4556,23.02.2021
Neuekirchen,Nougasant,421,17070,8443,8627,29.11.2021
Ostertor,Kässecroissant,689,19193,6818,12375,21.05.2021
Brothalle,Knüsperbrötchen,578,19174,8827,10347,16.10.2021
Achim,Weltmeisterbrötchen,319,12064,8674,3390,03.05.2021
Neuekirchen,Kässecroissant,506,20797,9643,11154,19.06.2021
Brothalle,Bumi,392,13541,9777,3764,04.01.2021
Ostertor,Weltmeisterbrötchen,314,17034,8508,8526,12.01.2021
Brothalle,Dinkelmalzbrötchen,395,15125,9454,5671,04.01.2021
Habenshausen,Bumi,449,13478,7008,6470,23.11.2021
Habenshausen,Knüsperbrötchen,421,15383,6266,9117,21.10.2021
Ostertor,Knüsperbrötchen,652,19517,6569,12948,19.11.2021
Achim,Knüsperbrötchen,406,15355,6901,8454,13.12.2021
Achim,Weltmeisterbrötchen,502,18207,7480,10727,12.06.2021
Hulsberg,Weltmeisterbrötchen,385,17411,8500,8911,06.01.2021
Ostertor,Kässecroissant,596,18558,9261,9297,16.04.2021
Brothalle,Nougasant,463,14401,6084,8317,29.06.2021
Achim,Kässecroissant,616,18882,8711,10171,09.10.2021
Hulsberg,Weltmeisterbrötchen,409,12467,6979,5488,07.02.2021
Ostertor,Kässecroissant,385,15707,9847,5860,15.03.2021
Neuekirchen,Nougasant,303,12501,9935,2566,11.03.2021
Neuekirchen,Nougasant,622,19227,7116,12111,27.02.2021
Achim,Knüsperbrötchen,569,20248,6042,14206,24.07.2021
Neuekirchen,Kässecroissant,388,12978,8844,4134,27.07.2021
Achim,Kässecroissant,582,20736,7422,13314,24.12.2021
Habenshausen,Knüsperbrötchen,343,16616,7778,8838,22.12.2021
Habenshausen,Weltmeisterbrötchen,382,14845,7243,7602,12.07.2021
Habenshausen,Bumi,386,17485,6331,11154,02.11.2021
Ostertor,Kässecroissant,541,19620,6120,13500,13.02.2021
Brothalle,Kässecroissant,547,18741,9192,9549,27.02.2021
Achim,Nougasant,348,16184,6613,9571,19.09.2021
Hulsberg,Weltmeisterbrötchen,358,14537,8725,5812,29.07.2021
Achim,Nougasant,374,16751,7366,9385,08.08.2021
Neuekirchen,Dinkelmalzbrötchen,467,13375,9808,3567,20.07.2021
Hulsberg,Bumi,546,19651,8506,11145,23.01.2021
Neuekirchen,Weltmeisterbrötchen,393,14179,6154,8025,20.12.2021
Achim,Bumi,376,15115,9638,5477,26.05.2021
Ostertor,Nougasant,473,14622,9999,4623,08.08.2021
Brothalle,Nougasant,451,14378,7632,6746,05.12.2021
Habenshausen,Nougasant,630,19197,8840,10357,25.06.2021
Brothalle,Bumi,496,13676,7279,6397,11.07.2021
Achim,Nougasant,560,20010,8213,11797,10.07.2021
Achim,Bumi,570,18042,8436,9606,19.03.2021
Ostertor,Dinkelmalzbrötchen,394,14113,6612,7501,23.05.2021
Neuekirchen,Bumi,410,14623,8932,5691,27.12.2021
Achim,Weltmeisterbrötchen,411,13395,6905,6490,29.07.2021
Hulsberg,Knüsperbrötchen,333,14893,9839,5054,23.11.2021
Achim,Bumi,321,12689,7221,5468,22.11.2021
Achim,Weltmeisterbrötchen,663,19142,7222,11920,28.05.2021
Ostertor,Weltmeisterbrötchen,435,12384,7890,4494,13.09.2021
Achim,Bumi,535,20344,9852,10492,29.10.2021
Habenshausen,Nougasant,306,12629,6080,6549,30.11.2021
Habenshausen,Nougasant,688,20887,6869,14018,01.05.2021
Hulsberg,Dinkelmalzbrötchen,433,17992,9623,8369,16.06.2021
Habenshausen,Nougasant,584,20096,9005,11091,20.03.2021
Brothalle,Knüsperbrötchen,360,12772,7309,5463,30.12.2021
Habenshausen,Knüsperbrötchen,332,15281,6514,8767,11.11.2021
Brothalle,Kässecroissant,440,13283,6955,6328,16.11.2021
Neuekirchen,Nougasant,500,12974,9117,3857,13.09.2021
Neuekirchen,Nougasant,484,14732,8087,6645,27.10.2021
Achim,Bumi,425,15441,8127,7314,15.08.2021
Achim,Weltmeisterbrötchen,400,14603,9147,5456,09.03.2021
Achim,Dinkelmalzbrötchen,329,13607,6889,6718,13.05.2021
Neuekirchen,Nougasant,302,15579,7052,8527,09.09.2021
Habenshausen,Nougasant,660,19899,9161,10738,21.08.2021
Achim,Weltmeisterbrötchen,400,16494,7154,9340,03.06.2021
Achim,Nougasant,323,15906,9450,6456,24.03.2021
Ostertor,Bumi,463,12398,6039,6359,20.06.2021
Brothalle,Weltmeisterbrötchen,489,13611,7986,5625,10.02.2021
Achim,Nougasant,533,20750,8370,12380,08.01.2021
Habenshausen,Weltmeisterbrötchen,358,17697,9579,8118,09.06.2021
Ostertor,Nougasant,440,15292,8477,6815,30.03.2021
Neuekirchen,Knüsperbrötchen,303,13749,7869,5880,18.10.2021
Neuekirchen,Weltmeisterbrötchen,481,13759,6943,6816,10.02.2021
Habenshausen,Bumi,403,16898,9792,7106,06.04.2021
Brothalle,Bumi,677,18409,7754,10655,18.06.2021
Ostertor,Knüsperbrötchen,464,17798,6431,11367,28.03.2021
Neuekirchen,Bumi,462,17646,8759,8887,04.07.2021
Ostertor,Knüsperbrötchen,435,14635,9531,5104,14.07.2021
Neuekirchen,Bumi,664,20294,8706,11588,10.12.2021
Achim,Bumi,433,17884,6101,11783,27.10.2021
Hulsberg,Nougasant,311,17819,9733,8086,15.12.2021
Hulsberg,Weltmeisterbrötchen,361,14507,8944,5563,14.12.2021
Brothalle,Weltmeisterbrötchen,330,15311,8554,6757,09.02.2021
Achim,Weltmeisterbrötchen,452,16011,8673,7338,21.07.2021
Ostertor,Bumi,449,12866,8878,3988,12.01.2021
Ostertor,Nougasant,356,13862,6972,6890,15.07.2021
Neuekirchen,Bumi,401,12994,7765,5229,24.02.2021
Achim,Dinkelmalzbrötchen,333,14166,6841,7325,22.06.2021
Brothalle,Knüsperbrötchen,358,15812,6764,9048,26.09.2021
Brothalle,Kässecroissant,428,17151,7268,9883,06.04.2021
Achim,Bumi,498,12336,8985,3351,03.05.2021
Neuekirchen,Bumi,621,18430,9294,9136,20.03.2021
Neuekirchen,Knüsperbrötchen,410,16904,6103,10801,20.05.2021
Brothalle,Nougasant,391,17217,9131,8086,24.08.2021
Brothalle,Knüsperbrötchen,359,12875,9301,3574,26.01.2021
Neuekirchen,Nougasant,411,13052,9768,3284,07.11.2021
Brothalle,Dinkelmalzbrötchen,336,15693,9786,5907,17.03.2021
Neuekirchen,Weltmeisterbrötchen,315,14005,9425,4580,17.08.2021
Brothalle,Dinkelmalzbrötchen,571,18714,6534,12180,30.07.2021
Achim,Knüsperbrötchen,652,19957,9592,10365,25.06.2021
Ostertor,Dinkelmalzbrötchen,319,14716,7412,7304,14.12.2021
Habenshausen,Bumi,401,12493,9555,2938,20.10.2021
Hulsberg,Nougasant,457,16254,6920,9334,15.02.2021
Achim,Bumi,315,15814,7730,8084,02.12.2021
Achim,Bumi,368,17335,9784,7551,09.08.2021
Hulsberg,Kässecroissant,397,14609,8089,6520,10.08.2021
Ostertor,Nougasant,566,20667,7436,13231,18.09.2021
Neuekirchen,Nougasant,441,15857,6469,9388,24.01.2021
Habenshausen,Weltmeisterbrötchen,331,12719,7301,5418,29.12.2021
Hulsberg,Nougasant,688,20222,8488,11734,08.01.2021
Habenshausen,Kässecroissant,386,14286,9068,5218,29.07.2021
Ostertor,Bumi,463,14844,9423,5421,09.03.2021
Achim,Bumi,457,14713,8162,6551,15.08.2021
Brothalle,Weltmeisterbrötchen,482,16288,7231,9057,06.10.2021
Habenshausen,Nougasant,493,13386,8795,4591,16.05.2021
Habenshausen,Weltmeisterbrötchen,321,14849,9161,5688,20.07.2021
Brothalle,Dinkelmalzbrötchen,619,18826,9350,9476,05.03.2021
Hulsberg,Knüsperbrötchen,632,20558,9834,10724,02.01.2021
Neuekirchen,Kässecroissant,478,15971,9529,6442,13.12.2021
Habenshausen,Weltmeisterbrötchen,505,19999,8560,11439,22.10.2021
Neuekirchen,Dinkelmalzbrötchen,594,18568,6014,12554,08.10.2021
Achim,Dinkelmalzbrötchen,630,19210,9009,10201,30.10.2021
Ostertor,Dinkelmalzbrötchen,433,13324,7800,5524,22.04.2021
Ostertor,Nougasant,538,19274,9965,9309,31.07.2021
Hulsberg,Nougasant,396,14738,9101,5637,17.10.2021
Brothalle,Bumi,456,14917,6546,8371,14.10.2021
Brothalle,Kässecroissant,441,14825,8929,5896,16.09.2021
Achim,Weltmeisterbrötchen,446,12770,6578,6192,29.09.2021
Brothalle,Weltmeisterbrötchen,405,15626,9490,6136,10.02.2021
Ostertor,Nougasant,415,16750,8674,8076,22.02.2021
Neuekirchen,Nougasant,482,12495,9413,3082,16.03.2021
Ostertor,Bumi,695,20862,6040,14822,23.10.2021
Neuekirchen,Dinkelmalzbrötchen,392,12923,8125,4798,27.09.2021
Achim,Bumi,632,19478,8475,11003,16.07.2021
Hulsberg,Nougasant,362,14598,6212,8386,23.05.2021
Achim,Bumi,351,13173,8949,4224,03.08.2021
Ostertor,Weltmeisterbrötchen,331,15903,9756,6147,30.05.2021
Brothalle,Bumi,492,17790,7872,9918,25.07.2021
Achim,Weltmeisterbrötchen,393,17590,8845,8745,08.12.2021
Habenshausen,Weltmeisterbrötchen,475,13935,9406,4529,06.10.2021
Habenshausen,Kässecroissant,614,20284,6344,13940,26.11.2021
Neuekirchen,Bumi,393,17951,9473,8478,02.09.2021
Hulsberg,Weltmeisterbrötchen,432,14958,7614,7344,20.09.2021
Ostertor,Weltmeisterbrötchen,322,13108,9634,3474,06.10.2021
Achim,Dinkelmalzbrötchen,511,18163,8853,9310,30.10.2021
Hulsberg,Nougasant,375,12352,8428,3924,22.03.2021
Ostertor,Nougasant,455,16407,7504,8903,13.09.2021
Brothalle,Bumi,431,17965,7626,10339,25.08.2021
Brothalle,Kässecroissant,312,15607,8891,6716,14.10.2021
Achim,Nougasant,370,12107,8443,3664,09.06.2021
Brothalle,Nougasant,320,16841,7218,9623,08.03.2021
Ostertor,Knüsperbrötchen,301,16160,9432,6728,04.10.2021
Habenshausen,Weltmeisterbrötchen,479,16510,8025,8485,07.11.2021
Hulsberg,Bumi,446,14838,8199,6639,19.08.2021
Ostertor,Bumi,596,20731,9927,10804,28.05.2021
Neuekirchen,Bumi,366,14640,9157,5483,17.10.2021
Achim,Weltmeisterbrötchen,451,17505,8154,9351,27.04.2021
Brothalle,Bumi,483,14272,9769,4503,11.01.2021
Habenshausen,Weltmeisterbrötchen,326,12617,9570,3047,21.12.2021
Habenshausen,Nougasant,324,15714,6473,9241,01.08.2021
Habenshausen,Nougasant,532,19228,9418,9810,17.09.2021
Habenshausen,Bumi,556,19451,6681,12770,15.10.2021
Ostertor,Nougasant,347,15459,8282,7177,05.07.2021
Hulsberg,Nougasant,421,13451,6586,6865,25.08.2021
Ostertor,Dinkelmalzbrötchen,548,19467,7837,11630,18.12.2021
Neuekirchen,Nougasant,492,16554,9676,6878,19.01.2021
Neuekirchen,Nougasant,500,16577,8371,8206,06.12.2021
Ostertor,Weltmeisterbrötchen,340,12696,7212,5484,10.06.2021
Brothalle,Bumi,347,16390,8041,8349,28.07.2021
Habenshausen,Weltmeisterbrötchen,464,16484,9589,6895,07.02.2021
Brothalle,Kässecroissant,625,20788,9542,11246,02.07.2021
Neuekirchen,Weltmeisterbrötchen,583,19860,8785,11075,21.08.2021
Neuekirchen,Kässecroissant,426,16752,6584,10168,16.09.2021
Ostertor,Bumi,365,16247,6818,9429,23.12.2021
Ostertor,Nougasant,300,13359,7822,5537,10.03.2021
Achim,Bumi,336,12295,7288,5007,18.08.2021
Habenshausen,Nougasant,319,17091,8464,8627,14.09.2021
Brothalle,Nougasant,604,19586,7834,11752,06.11.2021
Habenshausen,Bumi,379,13536,7192,6344,26.09.2021
Neuekirchen,Bumi,367,12608,6949,5659,27.09.2021
Neuekirchen,Nougasant,566,18040,9849,8191,19.02.2021
Achim,Bumi,396,16372,7088,9284,28.02.2021
Brothalle,Bumi,304,15204,9919,5285,10.08.2021
Ostertor,Nougasant,374,15230,6546,8684,14.04.2021
Brothalle,Bumi,319,15988,8770,7218,29.12.2021
Ostertor,Weltmeisterbrötchen,441,14956,7191,7765,16.08.2021
Neuekirchen,Knüsperbrötchen,395,12157,6243,5914,04.11.2021
Habenshausen,Weltmeisterbrötchen,536,18136,7941,10195,04.12.2021
Hulsberg,Kässecroissant,431,13176,6864,6312,13.04.2021
Achim,Knüsperbrötchen,408,14937,8043,6894,07.11.2021
Achim,Bumi,366,14377,6077,8300,13.07.2021
Achim,Dinkelmalzbrötchen,531,18466,7555,10911,24.04.2021
Habenshausen,Kässecroissant,330,15618,6887,8731,11.11.2021
Achim,Weltmeisterbrötchen,310,14401,7661,6740,19.12.2021
Hulsberg,Nougasant,631,18009,9154,8855,07.05.2021
Brothalle,Dinkelmalzbrötchen,366,14489,7569,6920,11.03.2021
Habenshausen,Bumi,382,17371,9662,7709,02.03.2021
Achim,Bumi,524,18469,6800,11669,28.08.2021
Neuekirchen,Kässecroissant,680,18784,6621,12163,13.08.2021
Achim,Weltmeisterbrötchen,548,20661,8508,12153,13.08.2021
Neuekirchen,Knüsperbrötchen,375,16025,6122,9903,26.07.2021
Achim,Weltmeisterbrötchen,314,14794,7958,6836,16.02.2021
Ostertor,Bumi,595,20621,6866,13755,02.04.2021
Achim,Kässecroissant,470,16913,7931,8982,20.12.2021
Achim,Nougasant,334,14439,8486,5953,06.06.2021
Achim,Weltmeisterbrötchen,497,17817,6127,11690,13.12.2021
Ostertor,Weltmeisterbrötchen,453,12144,9725,2419,06.06.2021
Ostertor,Weltmeisterbrötchen,308,17990,8341,9649,11.03.2021
Hulsberg,Knüsperbrötchen,368,12394,8759,3635,17.02.2021
Neuekirchen,Weltmeisterbrötchen,569,18227,7444,10783,11.06.2021
Neuekirchen,Bumi,450,14097,8278,5819,06.01.2021
Achim,Kässecroissant,471,14294,6135,8159,01.11.2021
Brothalle,Bumi,466,13256,6587,6669,05.10.2021
Habenshausen,Bumi,450,17004,9805,7199,18.01.2021
Ostertor,Dinkelmalzbrötchen,479,15804,7198,8606,17.03.2021
Hulsberg,Dinkelmalzbrötchen,566,19597,9171,10426,10.09.2021
Habenshausen,Kässecroissant,426,13984,7080,6904,11.02.2021
Ostertor,Nougasant,375,17048,8554,8494,14.02.2021
Neuekirchen,Weltmeisterbrötchen,409,13932,7248,6684,08.06.2021
Brothalle,Bumi,407,12257,7781,4476,11.05.2021
Neuekirchen,Nougasant,398,16696,6405,10291,13.10.2021
Habenshausen,Bumi,420,15526,9250,6276,24.03.2021
Achim,Bumi,368,17910,6233,11677,03.08.2021
Ostertor,Bumi,510,18187,9366,8821,28.05.2021
Achim,Nougasant,431,14199,8654,5545,01.09.2021
Hulsberg,Nougasant,693,19860,7644,12216,22.10.2021
Achim,Bumi,482,12757,8254,4503,03.03.2021
Ostertor,Bumi,376,16917,8751,8166,02.03.2021
Habenshausen,Weltmeisterbrötchen,574,20804,9381,11423,11.12.2021
Habenshausen,Bumi,590,18853,9364,9489,12.11.2021
Achim,Bumi,386,13962,6564,7398,02.02.2021
Brothalle,Bumi,425,16420,6519,9901,21.12.2021
Hulsberg,Kässecroissant,454,17363,8243,9120,04.07.2021
Achim,Kässecroissant,300,15606,7519,8087,10.11.2021
Ostertor,Weltmeisterbrötchen,409,12663,8380,4283,30.09.2021
Hulsberg,Nougasant,587,18305,7321,10984,19.03.2021
Brothalle,Bumi,571,20772,7390,13382,06.08.2021
Ostertor,Bumi,500,17061,7928,9133,03.02.2021
Achim,Bumi,576,18073,9948,8125,04.12.2021
Achim,Weltmeisterbrötchen,322,15397,7457,7940,14.12.2021
Hulsberg,Bumi,360,13333,7576,5757,23.05.2021
Hulsberg,Knüsperbrötchen,597,19585,6723,12862,05.11.2021
Brothalle,Weltmeisterbrötchen,438,17396,9297,8099,09.08.2021
Brothalle,Weltmeisterbrötchen,512,18254,6253,12001,19.02.2021
Ostertor,Dinkelmalzbrötchen,317,17777,7649,10128,25.08.2021
Hulsberg,Dinkelmalzbrötchen,455,17471,8314,9157,12.08.2021
Ostertor,Weltmeisterbrötchen,686,20024,8690,11334,09.01.2021
Ostertor,Kässecroissant,618,20262,9382,10880,02.10.2021
Neuekirchen,Nougasant,605,18096,7325,10771,28.08.2021
Habenshausen,Weltmeisterbrötchen,700,18158,8422,9736,23.09.2022
Hulsberg,Bumi,560,20371,9583,10788,16.09.2022
Habenshausen,Nougasant,442,16258,6042,10216,14.06.2022
Neuekirchen,Nougasant,438,16084,9980,6104,12.01.2022
Brothalle,Bumi,608,18075,9643,8432,05.02.2022
Ostertor,Bumi,621,20598,8861,11737,15.04.2022
Ostertor,Nougasant,653,18395,7679,10716,27.05.2022
Neuekirchen,Knüsperbrötchen,657,19090,8648,10442,22.04.2022
Brothalle,Weltmeisterbrötchen,484,16696,8527,8169,08.06.2022
Brothalle,Dinkelmalzbrötchen,585,18974,9284,9690,19.11.2022
Brothalle,Nougasant,337,17397,7346,10051,27.03.2022
Neuekirchen,Weltmeisterbrötchen,470,17576,8183,9393,18.12.2022
Habenshausen,Bumi,619,18425,8334,10091,29.10.2022
Brothalle,Weltmeisterbrötchen,352,12424,8610,3814,14.09.2022
Brothalle,Weltmeisterbrötchen,498,15645,8012,7633,28.02.2022
Achim,Weltmeisterbrötchen,617,19373,6237,13136,01.10.2022
Ostertor,Dinkelmalzbrötchen,375,14690,8852,5838,07.03.2022
Ostertor,Dinkelmalzbrötchen,530,19395,6136,13259,08.05.2022
Neuekirchen,Weltmeisterbrötchen,659,20474,9546,10928,02.04.2022
Brothalle,Weltmeisterbrötchen,372,13629,9735,3894,21.02.2022
Achim,Dinkelmalzbrötchen,414,17313,7257,10056,03.10.2022
Habenshausen,Nougasant,657,20888,9687,11201,28.10.2022
Hulsberg,Nougasant,341,15728,6304,9424,01.11.2022
Ostertor,Weltmeisterbrötchen,460,14890,7750,7140,08.08.2022
Neuekirchen,Knüsperbrötchen,469,14058,9040,5018,16.01.2022
Brothalle,Bumi,585,18469,6540,11929,24.09.2022
Ostertor,Weltmeisterbrötchen,495,15249,9387,5862,16.03.2022
Ostertor,Weltmeisterbrötchen,370,14967,8298,6669,23.06.2022
Hulsberg,Nougasant,403,13625,8245,5380,26.07.2022
Ostertor,Bumi,452,15304,7942,7362,27.02.2022
Hulsberg,Nougasant,372,13881,6997,6884,13.06.2022
Habenshausen,Knüsperbrötchen,474,13977,9777,4200,26.06.2022
Habenshausen,Nougasant,337,15059,9152,5907,25.08.2022
Hulsberg,Nougasant,397,14537,8090,6447,27.07.2022
Neuekirchen,Knüsperbrötchen,637,18845,7937,10908,28.01.2022
Habenshausen,Weltmeisterbrötchen,380,16811,8859,7952,30.11.2022
Achim,Weltmeisterbrötchen,388,16760,8562,8198,16.08.2022
Hulsberg,Weltmeisterbrötchen,429,15602,8613,6989,26.07.2022
Habenshausen,Dinkelmalzbrötchen,390,17782,9512,8270,24.11.2022
Brothalle,Kässecroissant,529,20459,9186,11273,03.09.2022
Achim,Dinkelmalzbrötchen,379,16119,8672,7447,23.02.2022
Brothalle,Nougasant,401,14014,9321,4693,04.05.2022
Brothalle,Weltmeisterbrötchen,640,19867,7015,12852,22.07.2022
Habenshausen,Bumi,351,15703,9237,6466,22.09.2022
Neuekirchen,Dinkelmalzbrötchen,484,14713,6342,8371,09.05.2022
Achim,Bumi,474,17817,6798,11019,29.11.2022
Achim,Nougasant,322,16929,6216,10713,26.07.2022
Ostertor,Weltmeisterbrötchen,589,19322,8331,10991,20.08.2022
Achim,Nougasant,446,12332,9366,2966,13.12.2022
Brothalle,Weltmeisterbrötchen,539,18432,7788,10644,17.09.2022
Neuekirchen,Weltmeisterbrötchen,593,20744,8891,11853,16.07.2022
Hulsberg,Bumi,518,18704,8068,10636,16.07.2022
Achim,Nougasant,442,12019,9664,2355,14.09.2022
Hulsberg,Weltmeisterbrötchen,466,13621,8750,4871,01.08.2022
Hulsberg,Nougasant,399,12345,7530,4815,26.04.2022
Brothalle,Knüsperbrötchen,480,15297,8455,6842,29.12.2022
Ostertor,Knüsperbrötchen,391,15155,6970,8185,03.05.2022
Ostertor,Nougasant,339,16034,6909,9125,13.04.2022
Hulsberg,Bumi,315,12585,6933,5652,28.12.2022
Hulsberg,Weltmeisterbrötchen,459,14770,7803,6967,21.03.2022
Brothalle,Weltmeisterbrötchen,453,14360,8767,5593,27.06.2022
Achim,Bumi,329,13200,8988,4212,09.05.2022
Hulsberg,Weltmeisterbrötchen,313,17128,7742,9386,05.10.2022
Ostertor,Nougasant,623,19335,8576,10759,04.02.2022
Hulsberg,Nougasant,375,17944,8893,9051,06.11.2022
Brothalle,Weltmeisterbrötchen,359,12877,8632,4245,04.07.2022
Brothalle,Nougasant,393,14590,6393,8197,10.07.2022
Ostertor,Dinkelmalzbrötchen,316,14006,6997,7009,19.12.2022
Neuekirchen,Dinkelmalzbrötchen,333,12722,9528,3194,07.07.2022
Achim,Knüsperbrötchen,636,19400,7603,11797,22.04.2022
Neuekirchen,Dinkelmalzbrötchen,540,19046,9630,9416,23.04.2022
Habenshausen,Nougasant,455,14517,7030,7487,15.06.2022
Hulsberg,Kässecroissant,455,13273,8105,5168,14.09.2022
Ostertor,Bumi,396,17334,9169,8165,22.09.2022
Achim,Bumi,331,12411,9914,2497,17.08.2022
Achim,Nougasant,333,13178,6548,6630,04.12.2022
Ostertor,Dinkelmalzbrötchen,489,14212,7227,6985,27.07.2022
Habenshausen,Bumi,592,20477,8872,11605,15.07.2022
Habenshausen,Nougasant,390,13723,9322,4401,13.03.2022
Neuekirchen,Kässecroissant,433,12807,6437,6370,14.08.2022
Habenshausen,Weltmeisterbrötchen,389,13111,9558,3553,21.09.2022
Brothalle,Bumi,514,20932,8449,12483,14.05.2022
Hulsberg,Weltmeisterbrötchen,338,13958,8546,5412,01.03.2022
Ostertor,Bumi,455,16562,8494,8068,19.01.2022
Achim,Bumi,321,14701,7833,6868,16.03.2022
Habenshausen,Knüsperbrötchen,338,16267,9985,6282,17.11.2022
Achim,Nougasant,337,15246,7880,7366,17.01.2022
Achim,Weltmeisterbrötchen,364,16837,8877,7960,12.05.2022
Brothalle,Nougasant,440,15159,6414,8745,19.01.2022
Neuekirchen,Nougasant,531,19730,7291,12439,01.07.2022
Achim,Nougasant,397,16437,6067,10370,19.05.2022
Achim,Bumi,376,14941,9931,5010,08.11.2022
Brothalle,Bumi,519,19621,8651,10970,15.04.2022
Habenshausen,Weltmeisterbrötchen,591,18126,9771,8355,11.02.2022
Achim,Bumi,623,18344,8491,9853,15.04.2022
Habenshausen,Nougasant,331,14435,6379,8056,20.11.2022
Achim,Bumi,623,19635,9140,10495,19.02.2022
Brothalle,Weltmeisterbrötchen,386,16179,8105,8074,21.12.2022
Hulsberg,Dinkelmalzbrötchen,457,14872,6295,8577,22.11.2022
Habenshausen,Nougasant,620,20156,9593,10563,13.05.2022
Hulsberg,Weltmeisterbrötchen,677,18246,7070,11176,13.05.2022
Brothalle,Weltmeisterbrötchen,386,17294,6528,10766,20.07.2022
Habenshausen,Weltmeisterbrötchen,358,17068,6178,10890,25.08.2022
Habenshausen,Kässecroissant,447,14578,8074,6504,30.08.2022
Habenshausen,Bumi,336,12669,9007,3662,09.06.2022
Ostertor,Bumi,422,16580,6019,10561,22.08.2022
Neuekirchen,Nougasant,410,16495,8009,8486,20.11.2022
Brothalle,Weltmeisterbrötchen,316,16709,8090,8619,08.09.2022
Hulsberg,Dinkelmalzbrötchen,492,16369,7270,9099,25.10.2022
Neuekirchen,Bumi,379,17942,7756,10186,10.10.2022
Habenshausen,Bumi,537,18919,9328,9591,13.08.2022
Ostertor,Nougasant,590,18809,8968,9841,26.02.2022
Achim,Weltmeisterbrötchen,425,15598,8898,6700,03.07.2022
Neuekirchen,Kässecroissant,553,19464,8147,11317,19.03.2022
Achim,Nougasant,649,20648,6976,13672,19.11.2022
Achim,Bumi,688,18271,8261,10010,15.04.2022
Neuekirchen,Nougasant,443,12155,6058,6097,08.06.2022
Brothalle,Dinkelmalzbrötchen,475,14586,6763,7823,28.11.2022
Neuekirchen,Nougasant,364,12851,6356,6495,16.02.2022
Hulsberg,Weltmeisterbrötchen,630,20691,6234,14457,13.05.2022
Brothalle,Bumi,570,18916,7601,11315,03.06.2022
Brothalle,Nougasant,468,13558,8461,5097,13.04.2022
Neuekirchen,Bumi,446,15201,7721,7480,04.04.2022
Habenshausen,Weltmeisterbrötchen,347,13696,8002,5694,16.10.2022
Habenshausen,Bumi,435,13073,7215,5858,15.02.2022
Ostertor,Bumi,551,20897,9438,11459,26.03.2022
Brothalle,Dinkelmalzbrötchen,341,17083,8634,8449,16.10.2022
Hulsberg,Weltmeisterbrötchen,377,16332,6607,9725,27.06.2022
Habenshausen,Bumi,495,13789,7045,6744,24.02.2022
Achim,Knüsperbrötchen,434,12026,6196,5830,20.11.2022
Achim,Nougasant,332,12556,9129,3427,28.02.2022
Achim,Nougasant,591,20503,8861,11642,15.10.2022
Ostertor,Bumi,405,16860,8201,8659,15.08.2022
Brothalle,Bumi,625,18932,8130,10802,25.06.2022
Achim,Bumi,543,20527,8202,12325,14.10.2022
Ostertor,Nougasant,606,19354,8989,10365,03.06.2022
Achim,Bumi,354,12113,9690,2423,07.02.2022
Hulsberg,Bumi,313,12875,6909,5966,14.08.2022
Neuekirchen,Weltmeisterbrötchen,474,17285,9995,7290,20.06.2022
Neuekirchen,Nougasant,637,20523,8904,11619,19.08.2022
Hulsberg,Weltmeisterbrötchen,677,19014,8031,10983,26.03.2022
Achim,Bumi,385,12133,9060,3073,13.04.2022
Habenshausen,Kässecroissant,527,18268,6219,12049,19.11.2022
Brothalle,Bumi,376,14029,7440,6589,25.10.2022
Achim,Kässecroissant,569,20131,6202,13929,02.07.2022
Ostertor,Weltmeisterbrötchen,403,14510,8124,6386,04.01.2022
Ostertor,Bumi,316,12199,9535,2664,18.09.2022
Ostertor,Dinkelmalzbrötchen,657,19204,8261,10943,20.05.2022
Brothalle,Weltmeisterbrötchen,479,12323,8599,3724,19.12.2022
Hulsberg,Nougasant,488,14850,7326,7524,01.02.2022
Hulsberg,Bumi,520,19601,7892,11709,16.07.2022
Ostertor,Weltmeisterbrötchen,307,13537,6850,6687,31.08.2022
Ostertor,Bumi,481,14232,8855,5377,27.11.2022
Achim,Knüsperbrötchen,390,16135,7715,8420,04.05.2022
Brothalle,Bumi,369,13466,7237,6229,12.07.2022
Habenshausen,Bumi,659,19006,9551,9455,04.02.2022
Brothalle,Kässecroissant,359,13927,9587,4340,07.06.2022
Hulsberg,Weltmeisterbrötchen,399,17785,8085,9700,16.03.2022
Hulsberg,Kässecroissant,392,12622,8335,4287,19.12.2022
Ostertor,Kässecroissant,433,14515,6614,7901,02.03.2022
Habenshausen,Nougasant,615,18696,6440,12256,11.02.2022
Neuekirchen,Kässecroissant,316,12579,8653,3926,01.12.2022
Neuekirchen,Dinkelmalzbrötchen,425,15918,7628,8290,27.03.2022
Hulsberg,Dinkelmalzbrötchen,389,16325,7045,9280,26.12.2022
Ostertor,Bumi,351,13192,7944,5248,23.02.2022
Achim,Weltmeisterbrötchen,647,18509,9290,9219,27.05.2022
Habenshausen,Bumi,364,17142,7481,9661,12.01.2022
Brothalle,Weltmeisterbrötchen,376,15325,8695,6630,03.07.2022
Achim,Dinkelmalzbrötchen,379,16710,6059,10651,11.09.2022
Hulsberg,Bumi,397,14413,9648,4765,15.03.2022
Habenshausen,Nougasant,380,17839,8147,9692,12.01.2022
Ostertor,Kässecroissant,575,18362,7541,10821,12.08.2022
Achim,Bumi,303,13798,8741,5057,09.11.2022
Hulsberg,Weltmeisterbrötchen,599,18277,9290,8987,21.05.2022
Hulsberg,Weltmeisterbrötchen,695,20327,9987,10340,10.12.2022
Ostertor,Bumi,342,13754,8104,5650,17.10.2022
Ostertor,Bumi,363,13204,6807,6397,11.12.2022
Hulsberg,Bumi,392,17874,7223,10651,20.09.2022
Hulsberg,Knüsperbrötchen,493,16943,7962,8981,10.11.2022
Neuekirchen,Knüsperbrötchen,697,20324,6267,14057,29.04.2022
Achim,Weltmeisterbrötchen,399,14870,6121,8749,03.03.2022
Ostertor,Nougasant,407,16312,6033,10279,17.05.2022
Neuekirchen,Bumi,571,20206,6794,13412,05.03.2022
Neuekirchen,Nougasant,451,13747,9120,4627,15.09.2022
Brothalle,Knüsperbrötchen,632,18871,8154,10717,16.12.2022
Neuekirchen,Nougasant,511,19105,7793,11312,24.06.2022
Habenshausen,Bumi,437,14003,9911,4092,08.11.2022
Brothalle,Knüsperbrötchen,619,19613,6864,12749,24.12.2022
Achim,Bumi,323,17797,8441,9356,01.12.2022
Achim,Knüsperbrötchen,522,19384,6565,12819,23.12.2022
Ostertor,Nougasant,632,18191,7953,10238,17.12.2022
Ostertor,Kässecroissant,305,17803,6321,11482,01.05.2022
Brothalle,Weltmeisterbrötchen,626,20929,6514,14415,08.10.2022
Ostertor,Knüsperbrötchen,363,13043,7580,5463,25.07.2022
Hulsberg,Knüsperbrötchen,350,17903,8252,9651,05.01.2022
Neuekirchen,Weltmeisterbrötchen,358,12060,9047,3013,13.03.2022
Brothalle,Weltmeisterbrötchen,409,17010,8693,8317,27.04.2022
Ostertor,Weltmeisterbrötchen,482,17411,7825,9586,01.03.2022
Achim,Kässecroissant,652,18724,8052,10672,08.04.2022
Habenshausen,Weltmeisterbrötchen,415,17945,8140,9805,17.07.2022
Hulsberg,Dinkelmalzbrötchen,388,12832,9721,3111,16.03.2022
Habenshausen,Bumi,387,12144,7736,4408,18.05.2022
Neuekirchen,Nougasant,550,20983,6634,14349,30.12.2022
Brothalle,Bumi,578,19312,7743,11569,25.06.2022
Hulsberg,Bumi,441,14325,9234,5091,20.10.2022
Brothalle,Nougasant,310,17228,7893,9335,10.07.2022
Habenshausen,Bumi,383,16806,8660,8146,08.08.2022
Habenshausen,Nougasant,362,14389,7965,6424,11.10.2022
Hulsberg,Weltmeisterbrötchen,330,15097,8172,6925,25.08.2022
Neuekirchen,Weltmeisterbrötchen,469,15514,8470,7044,25.07.2022
Hulsberg,Nougasant,500,16180,6483,9697,11.07.2022
Ostertor,Nougasant,427,17811,8700,9111,23.10.2022
Achim,Knüsperbrötchen,483,17093,7477,9616,14.02.2022
Brothalle,Nougasant,360,16606,9655,6951,02.06.2022
Neuekirchen,Bumi,322,13230,9932,3298,19.05.2022
Ostertor,Dinkelmalzbrötchen,536,18285,6818,11467,25.02.2022
Brothalle,Bumi,337,12456,6755,5701,20.09.2022
Habenshausen,Weltmeisterbrötchen,700,19798,6130,13668,05.08.2022
Brothalle,Nougasant,430,16499,6510,9989,04.10.2022
Brothalle,Weltmeisterbrötchen,599,19543,6969,12574,11.11.2022
Brothalle,Weltmeisterbrötchen,346,15967,6543,9424,17.01.2022
Achim,Nougasant,351,15218,7905,7313,31.07.2022
Ostertor,Bumi,386,13331,9641,3690,08.02.2022
Ostertor,Nougasant,683,20752,6263,14489,08.10.2022
Ostertor,Bumi,695,18553,8698,9855,23.04.2022
Achim,Weltmeisterbrötchen,352,12731,6685,6046,01.08.2022
Ostertor,Weltmeisterbrötchen,328,13051,6992,6059,08.08.2022
Brothalle,Bumi,316,13154,9798,3356,19.01.2022
Brothalle,Weltmeisterbrötchen,301,17199,6932,10267,16.08.2022
Achim,Kässecroissant,321,17919,7704,10215,21.12.2022
Ostertor,Bumi,458,15773,8737,7036,10.04.2022
Hulsberg,Knüsperbrötchen,540,20456,9240,11216,05.03.2022
Habenshausen,Weltmeisterbrötchen,629,18970,9698,9272,15.10.2022
Achim,Bumi,682,19931,8952,10979,19.03.2022
Achim,Nougasant,644,20703,9444,11259,02.10.2022
Habenshausen,Nougasant,545,20907,6138,14769,14.05.2022
Brothalle,Bumi,397,12467,8258,4209,12.09.2022
Brothalle,Nougasant,533,19057,7350,11707,20.05.2022
Achim,Weltmeisterbrötchen,490,15727,7091,8636,15.09.2022
Brothalle,Dinkelmalzbrötchen,350,12712,6712,6000,02.03.2022
Hulsberg,Dinkelmalzbrötchen,502,20050,6097,13953,08.01.2022
Neuekirchen,Bumi,440,16757,7234,9523,17.03.2022
Habenshausen,Nougasant,524,20171,7985,12186,20.08.2022
Brothalle,Weltmeisterbrötchen,540,18427,8005,10422,01.07.2022
Habenshausen,Bumi,306,12969,9858,3111,04.09.2022
Habenshausen,Dinkelmalzbrötchen,440,12034,7935,4099,14.02.2022
Brothalle,Weltmeisterbrötchen,529,20704,9011,11693,25.06.2022
Neuekirchen,Bumi,695,18897,9016,9881,16.12.2022
Ostertor,Bumi,454,14740,6287,8453,09.08.2022
Neuekirchen,Weltmeisterbrötchen,462,12420,7578,4842,16.02.2022
Achim,Bumi,316,17136,8153,8983,06.10.2022
Achim,Weltmeisterbrötchen,589,18807,8613,10194,03.09.2022
Brothalle,Bumi,560,18854,7877,10977,23.07.2022
Ostertor,Nougasant,390,15087,7237,7850,14.04.2022
Ostertor,Dinkelmalzbrötchen,657,20788,8137,12651,07.01.2022
Neuekirchen,Nougasant,601,20409,9856,10553,02.12.2022
Habenshausen,Bumi,483,13315,6650,6665,03.10.2022
Neuekirchen,Weltmeisterbrötchen,339,13773,8907,4866,21.11.2022
Brothalle,Bumi,354,16023,7292,8731,10.08.2022
Neuekirchen,Nougasant,395,13626,6957,6669,01.12.2022
Achim,Nougasant,538,18937,6822,12115,02.07.2022
Ostertor,Knüsperbrötchen,365,12439,6270,6169,21.11.2022
Ostertor,Nougasant,688,20781,6904,13877,29.04.2022
Hulsberg,Bumi,328,13232,8751,4481,03.07.2022
Habenshausen,Weltmeisterbrötchen,645,19042,7680,11362,23.04.2022
Neuekirchen,Weltmeisterbrötchen,469,17032,9976,7056,03.04.2022
Habenshausen,Nougasant,619,19334,8483,10851,20.08.2022
Brothalle,Weltmeisterbrötchen,393,14403,6555,7848,17.01.2022
Neuekirchen,Nougasant,469,16157,8487,7670,15.06.2022
Achim,Kässecroissant,495,13588,6053,7535,01.05.2022
Neuekirchen,Weltmeisterbrötchen,499,12635,8200,4435,02.03.2022
Ostertor,Dinkelmalzbrötchen,324,15577,7870,7707,17.02.2022
Ostertor,Weltmeisterbrötchen,499,13131,9886,3245,30.06.2022
Achim,Nougasant,304,13588,9907,3681,17.07.2022
Neuekirchen,Nougasant,496,17633,6272,11361,15.05.2022
Ostertor,Bumi,428,13575,6462,7113,18.01.2022
Achim,Bumi,384,13652,6113,7539,27.11.2022
Habenshausen,Kässecroissant,455,16340,8666,7674,25.04.2022
Habenshausen,Nougasant,319,17498,9439,8059,22.02.2022
Hulsberg,Weltmeisterbrötchen,575,19477,6837,12640,28.10.2022
Habenshausen,Weltmeisterbrötchen,394,13153,6065,7088,13.10.2022
Brothalle,Weltmeisterbrötchen,326,15835,6901,8934,08.06.2022
Neuekirchen,Bumi,392,17006,6495,10511,04.08.2022
Neuekirchen,Nougasant,457,14282,7011,7271,05.12.2022
Brothalle,Weltmeisterbrötchen,526,20645,6616,14029,09.12.2022
Ostertor,Bumi,373,13418,9905,3513,20.02.2022
Brothalle,Kässecroissant,322,15252,8622,6630,07.04.2022
Ostertor,Weltmeisterbrötchen,528,18543,8627,9916,26.03.2022
Ostertor,Nougasant,351,13481,9294,4187,27.11.2022
Habenshausen,Weltmeisterbrötchen,429,13120,7126,5994,22.08.2022
Habenshausen,Weltmeisterbrötchen,406,12484,8555,3929,28.09.2022
Habenshausen,Bumi,481,12046,8017,4029,14.12.2022
Neuekirchen,Weltmeisterbrötchen,325,14393,6734,7659,16.08.2022
Habenshausen,Weltmeisterbrötchen,433,13320,8392,4928,16.06.2022
Ostertor,Nougasant,442,13530,8741,4789,09.11.2022
Hulsberg,Nougasant,307,13855,6359,7496,13.07.2022
Neuekirchen,Nougasant,316,13718,9888,3830,23.11.2022
Achim,Nougasant,317,12274,9951,2323,20.11.2022
Neuekirchen,Weltmeisterbrötchen,564,20959,9697,11262,18.11.2022
Neuekirchen,Bumi,355,16160,8074,8086,28.02.2022
Hulsberg,Knüsperbrötchen,356,16267,7356,8911,25.10.2022
Neuekirchen,Nougasant,487,13307,7394,5913,18.07.2022
Neuekirchen,Bumi,573,19157,7601,11556,19.11.2022
Habenshausen,Weltmeisterbrötchen,433,17441,8711,8730,28.11.2022
Ostertor,Nougasant,510,18161,9234,8927,28.10.2022
Neuekirchen,Dinkelmalzbrötchen,520,19755,6825,12930,18.03.2022
Hulsberg,Knüsperbrötchen,384,12618,8075,4543,30.11.2022
Neuekirchen,Weltmeisterbrötchen,357,15421,6759,8662,14.03.2022
Brothalle,Weltmeisterbrötchen,387,17277,9170,8107,19.12.2022
Hulsberg,Nougasant,558,18162,6872,11290,07.01.2022
Ostertor,Weltmeisterbrötchen,382,15846,6077,9769,27.03.2022
Ostertor,Dinkelmalzbrötchen,486,16467,9216,7251,28.02.2022
Ostertor,Bumi,327,13855,8812,5043,30.11.2022
Neuekirchen,Weltmeisterbrötchen,311,14195,7854,6341,24.08.2022
Neuekirchen,Nougasant,668,19283,7927,11356,05.03.2022
Ostertor,Dinkelmalzbrötchen,616,18100,6761,11339,13.05.2022
Achim,Weltmeisterbrötchen,340,13084,8316,4768,20.09.2022
Ostertor,Nougasant,365,12718,9369,3349,20.04.2022
Achim,Weltmeisterbrötchen,313,16121,8156,7965,13.11.2022
Achim,Weltmeisterbrötchen,438,14089,6406,7683,18.05.2022
Achim,Weltmeisterbrötchen,467,15064,8076,6988,28.07.2022
Neuekirchen,Weltmeisterbrötchen,439,12218,6819,5399,30.05.2022
Neuekirchen,Nougasant,438,13706,6087,7619,18.01.2022
Brothalle,Knüsperbrötchen,328,12422,9692,2730,04.05.2022
Habenshausen,Weltmeisterbrötchen,450,17342,9856,7486,14.06.2022
Brothalle,Nougasant,326,17900,7969,9931,08.03.2022
Neuekirchen,Nougasant,470,16200,6645,9555,21.11.2022
Ostertor,Bumi,414,17241,8076,9165,01.08.2022
Achim,Weltmeisterbrötchen,601,18972,8138,10834,28.10.2022
Habenshausen,Nougasant,384,13242,6012,7230,17.04.2022
Habenshausen,Weltmeisterbrötchen,395,17635,7238,10397,03.08.2022
Hulsberg,Nougasant,551,19498,9318,10180,11.03.2022
Habenshausen,Nougasant,463,16241,9458,6783,01.11.2022
Brothalle,Bumi,415,13535,7702,5833,19.01.2022
Brothalle,Weltmeisterbrötchen,300,16037,7921,8116,26.01.2022
Brothalle,Knüsperbrötchen,500,12589,9185,3404,22.09.2022
Achim,Nougasant,445,17035,6168,10867,21.11.2022
Habenshausen,Weltmeisterbrötchen,372,14991,9069,5922,24.05.2022
Achim,Nougasant,413,16050,7166,8884,21.08.2022
Neuekirchen,Nougasant,461,14994,8494,6500,05.10.2022
Achim,Weltmeisterbrötchen,484,13716,7169,6547,18.04.2022
Ostertor,Kässecroissant,441,14151,7519,6632,14.12.2022
Hulsberg,Bumi,451,13356,7161,6195,04.05.2022
Achim,Bumi,678,18722,7247,11475,11.02.2022
Ostertor,Bumi,316,16685,6010,10675,24.11.2022
Ostertor,Nougasant,612,20721,7455,13266,01.07.2022
Hulsberg,Weltmeisterbrötchen,358,12616,8746,3870,17.04.2022
Neuekirchen,Weltmeisterbrötchen,586,18859,6763,12096,11.02.2022
Brothalle,Dinkelmalzbrötchen,300,15860,8922,6938,27.07.2022
Hulsberg,Kässecroissant,467,14999,9715,5284,14.11.2022
Hulsberg,Knüsperbrötchen,382,15158,7195,7963,09.02.2022
Hulsberg,Bumi,364,12646,8148,4498,06.07.2022
Brothalle,Nougasant,420,12675,7801,4874,21.09.2022
Neuekirchen,Knüsperbrötchen,548,18690,9838,8852,05.03.2022
Brothalle,Bumi,334,12331,8611,3720,10.08.2022
Hulsberg,Weltmeisterbrötchen,698,20463,9229,11234,30.12.2022
Hulsberg,Kässecroissant,689,19245,7200,12045,23.09.2022
Hulsberg,Bumi,452,15577,8316,7261,10.08.2022
Habenshausen,Weltmeisterbrötchen,502,19001,9836,9165,12.03.2022
Brothalle,Kässecroissant,492,14461,6489,7972,02.08.2022
Ostertor,Nougasant,687,19901,8849,11052,30.09.2022
Neuekirchen,Bumi,318,14031,8049,5982,14.08.2022
Habenshausen,Bumi,461,12684,6682,6002,16.11.2022
Brothalle,Bumi,457,14407,8842,5565,21.03.2022
Ostertor,Nougasant,315,13332,9987,3345,05.12.2022
Neuekirchen,Bumi,536,18359,8099,10260,17.12.2022
Ostertor,Nougasant,325,15642,7171,8471,29.09.2022
Brothalle,Bumi,388,14270,7133,7137,21.09.2022
Hulsberg,Nougasant,402,12819,6786,6033,07.11.2022
Habenshausen,Bumi,303,15032,9198,5834,09.05.2022
Hulsberg,Nougasant,696,18724,7687,11037,27.05.2022
Achim,Weltmeisterbrötchen,522,20982,9924,11058,26.03.2022
Neuekirchen,Weltmeisterbrötchen,463,12113,8434,3679,08.03.2022
Hulsberg,Weltmeisterbrötchen,675,19522,7849,11673,15.07.2022
Habenshausen,Knüsperbrötchen,555,18550,9708,8842,04.11.2022
Hulsberg,Nougasant,392,12046,8158,3888,18.04.2022
Hulsberg,Weltmeisterbrötchen,433,16189,8920,7269,11.10.2022
Habenshausen,Bumi,399,16342,6909,9433,20.04.2022
Achim,Bumi,326,12960,9226,3734,13.06.2022
Neuekirchen,Nougasant,564,20882,7267,13615,09.07.2022
Neuekirchen,Bumi,583,20582,9001,11581,15.04.2022
Achim,Kässecroissant,350,17027,6046,10981,06.10.2022
Achim,Weltmeisterbrötchen,427,16123,7662,8461,18.04.2022
Achim,Nougasant,309,14496,6523,7973,02.06.2022
Hulsberg,Nougasant,444,16455,8398,8057,29.08.2022
Brothalle,Dinkelmalzbrötchen,567,18701,6700,12001,25.03.2022
Hulsberg,Dinkelmalzbrötchen,527,19793,8411,11382,26.02.2022
Hulsberg,Weltmeisterbrötchen,508,19977,9841,10136,01.04.2022
Achim,Knüsperbrötchen,318,13215,8799,4416,06.02.2022
Ostertor,Bumi,556,20211,8135,12076,24.06.2022
Hulsberg,Weltmeisterbrötchen,302,12562,9097,3465,17.03.2022
Ostertor,Weltmeisterbrötchen,549,19638,6936,12702,04.02.2022
Hulsberg,Nougasant,455,17554,6319,11235,23.02.2022
Neuekirchen,Bumi,464,14744,7375,7369,09.10.2022
Hulsberg,Weltmeisterbrötchen,444,17726,8955,8771,15.05.2022
Neuekirchen,Bumi,648,19166,7982,11184,28.10.2022
Achim,Bumi,329,13399,8581,4818,12.10.2022
Ostertor,Weltmeisterbrötchen,696,19523,6366,13157,11.06.2022
Ostertor,Nougasant,487,16898,7070,9828,09.06.2022
Neuekirchen,Nougasant,386,13649,8620,5029,20.07.2022
Habenshausen,Knüsperbrötchen,690,19470,7703,11767,28.10.2022
Achim,Nougasant,305,13038,9221,3817,15.08.2022
Neuekirchen,Bumi,528,20322,9789,10533,22.07.2022
Neuekirchen,Weltmeisterbrötchen,434,12059,9716,2343,27.03.2022
Hulsberg,Kässecroissant,449,15641,9337,6304,12.04.2022
Habenshausen,Weltmeisterbrötchen,448,16760,6699,10061,27.04.2022
Achim,Nougasant,317,17222,7195,10027,11.07.2022
Neuekirchen,Knüsperbrötchen,434,12337,8222,4115,20.09.2022
Neuekirchen,Dinkelmalzbrötchen,347,17561,7842,9719,03.08.2022
Ostertor,Bumi,351,15829,7081,8748,29.11.2022
Habenshausen,Weltmeisterbrötchen,324,17641,9108,8533,01.09.2022
Achim,Weltmeisterbrötchen,470,15633,8390,7243,09.03.2022
Hulsberg,Bumi,384,13665,7917,5748,16.11.2022
Habenshausen,Nougasant,307,17330,6801,10529,09.08.2022
Neuekirchen,Bumi,545,19445,8703,10742,01.07.2022
Hulsberg,Weltmeisterbrötchen,479,13429,6454,6975,26.01.2022
Ostertor,Weltmeisterbrötchen,382,14016,9064,4952,21.11.2022
Hulsberg,Kässecroissant,342,13586,9659,3927,07.03.2022
Habenshausen,Nougasant,427,13829,7938,5891,02.03.2022
Ostertor,Weltmeisterbrötchen,522,20406,6580,13826,25.02.2022
Ostertor,Nougasant,503,20421,7387,13034,01.07.2022
Ostertor,Kässecroissant,459,16267,8016,8251,15.09.2022
Hulsberg,Nougasant,398,17316,7502,9814,12.12.2022
Hulsberg,Weltmeisterbrötchen,684,18229,8979,9250,28.05.2022
Brothalle,Weltmeisterbrötchen,321,15081,7284,7797,10.01.2022
Brothalle,Nougasant,596,18950,6258,12692,17.09.2022
Brothalle,Bumi,394,14260,9597,4663,27.01.2022
Achim,Weltmeisterbrötchen,340,13297,6433,6864,12.12.2022
Habenshausen,Bumi,318,16793,6470,10323,22.05.2022
Achim,Nougasant,690,19024,6794,12230,22.01.2022
Achim,Nougasant,476,17938,7630,10308,14.09.2022
Brothalle,Weltmeisterbrötchen,506,20639,8398,12241,07.01.2022
Achim,Nougasant,395,14382,9802,4580,20.04.2022
Ostertor,Bumi,649,20496,8893,11603,10.06.2022
Habenshausen,Kässecroissant,384,17802,6720,11082,04.08.2022
Brothalle,Dinkelmalzbrötchen,478,14946,6670,8276,05.05.2022
Ostertor,Kässecroissant,489,12616,8958,3658,25.01.2022
Brothalle,Weltmeisterbrötchen,357,15980,9066,6914,22.05.2022
Neuekirchen,Nougasant,430,16770,8569,8201,24.10.2022
Ostertor,Nougasant,405,13134,8763,4371,20.12.2022
Achim,Kässecroissant,412,12510,8149,4361,29.06.2022
Habenshausen,Bumi,698,18896,7912,10984,30.09.2022
Achim,Nougasant,329,14322,9276,5046,01.12.2022
Neuekirchen,Nougasant,360,17279,6953,10326,01.02.2022
Neuekirchen,Knüsperbrötchen,330,17021,9987,7034,07.09.2022
Habenshausen,Weltmeisterbrötchen,636,18239,7865,10374,19.11.2022
Achim,Bumi,329,12660,6689,5971,05.12.2022
Ostertor,Nougasant,454,14861,6111,8750,10.11.2022
Brothalle,Bumi,541,20325,7068,13257,08.05.2022
Ostertor,Nougasant,518,18411,9764,8647,16.04.2022
Hulsberg,Weltmeisterbrötchen,560,18381,7841,10540,31.12.2022
Neuekirchen,Weltmeisterbrötchen,427,17709,6439,11270,24.02.2022
Neuekirchen,Kässecroissant,414,15545,9258,6287,07.03.2022
Habenshausen,Kässecroissant,436,14332,7242,7090,17.03.2022
Brothalle,Dinkelmalzbrötchen,427,12733,7562,5171,22.06.2022
Ostertor,Bumi,387,14410,7218,7192,22.08.2022
Achim,Weltmeisterbrötchen,360,14437,6819,7618,04.04.2022
Neuekirchen,Weltmeisterbrötchen,466,17945,8540,9405,28.07.2022
Hulsberg,Weltmeisterbrötchen,316,14664,8665,5999,23.01.2022
Brothalle,Nougasant,429,16458,8396,8062,04.08.2022
Brothalle,Nougasant,363,12895,8149,4746,04.05.2022
Hulsberg,Bumi,376,17704,8883,8821,10.03.2022
Hulsberg,Weltmeisterbrötchen,656,20688,6718,13970,30.09.2022
Habenshausen,Kässecroissant,369,16787,9463,7324,19.06.2022
Ostertor,Bumi,441,15319,8121,7198,20.09.2022
Brothalle,Kässecroissant,365,14750,7107,7643,05.05.2022
Hulsberg,Nougasant,445,13283,9151,4132,18.09.2022
Neuekirchen,Weltmeisterbrötchen,629,19656,8017,11639,30.10.2022
Ostertor,Bumi,374,13608,8553,5055,18.01.2022
Neuekirchen,Kässecroissant,695,18669,6356,12313,16.07.2022
Brothalle,Kässecroissant,617,18732,7471,11261,17.09.2022
Brothalle,Bumi,386,17541,6128,11413,22.02.2022
Ostertor,Weltmeisterbrötchen,517,20335,8604,11731,04.03.2022
Brothalle,Weltmeisterbrötchen,492,13800,6342,7458,23.03.2022
Neuekirchen,Bumi,405,14688,6945,7743,11.04.2022
Achim,Nougasant,373,13767,7518,6249,11.04.2022
Habenshausen,Bumi,399,15405,8811,6594,18.09.2022
Neuekirchen,Dinkelmalzbrötchen,433,14146,7440,6706,09.10.2022
Hulsberg,Nougasant,538,18244,7130,11114,11.02.2022
Neuekirchen,Bumi,314,12760,9452,3308,13.03.2022
Neuekirchen,Knüsperbrötchen,621,18012,6229,11783,15.07.2022
Neuekirchen,Nougasant,332,13758,7291,6467,07.03.2022
Neuekirchen,Kässecroissant,377,17732,6527,11205,06.06.2022
Ostertor,Bumi,650,19417,8090,11327,19.02.2022
Habenshausen,Bumi,302,12167,9621,2546,15.11.2022
Achim,Nougasant,478,12229,8842,3387,24.08.2022
Brothalle,Weltmeisterbrötchen,425,16437,9162,7275,14.06.2022
Ostertor,Weltmeisterbrötchen,521,18975,9108,9867,25.11.2022
Hulsberg,Kässecroissant,578,18796,7964,10832,21.10.2022
Hulsberg,Nougasant,648,19787,8644,11143,02.04.2022
Brothalle,Knüsperbrötchen,536,19257,6680,12577,21.01.2022
Neuekirchen,Knüsperbrötchen,548,20421,9754,10667,26.03.2022
Habenshausen,Nougasant,485,12534,6617,5917,13.11.2022
Neuekirchen,Bumi,314,15841,8571,7270,11.01.2022
Hulsberg,Bumi,447,15297,6793,8504,13.12.2022
Achim,Knüsperbrötchen,422,17260,6748,10512,17.04.2022
Achim,Weltmeisterbrötchen,365,12095,7329,4766,28.11.2022
Hulsberg,Bumi,397,15804,9001,6803,22.03.2022
Habenshausen,Weltmeisterbrötchen,373,12733,8448,4285,24.11.2022
Hulsberg,Knüsperbrötchen,458,14888,8000,6888,29.06.2022
Brothalle,Nougasant,390,17681,7516,10165,01.03.2023
Habenshausen,Weltmeisterbrötchen,320,13712,7650,6062,30.08.2023
Brothalle,Nougasant,452,14535,8312,6223,03.10.2023
Ostertor,Bumi,361,15695,6953,8742,16.11.2023
Habenshausen,Nougasant,304,12258,6122,6136,08.10.2023
Ostertor,Nougasant,307,17631,8127,9504,20.07.2023
Ostertor,Nougasant,379,17342,7122,10220,14.08.2023
Habenshausen,Weltmeisterbrötchen,523,20200,8652,11548,02.09.2023
Hulsberg,Nougasant,545,20142,8200,11942,31.03.2023
Ostertor,Weltmeisterbrötchen,369,15435,7009,8426,24.07.2023
Habenshausen,Nougasant,480,12118,6280,5838,23.02.2023
Achim,Bumi,451,15268,9718,5550,07.05.2023
Achim,Weltmeisterbrötchen,315,14380,9602,4778,27.06.2023
Neuekirchen,Dinkelmalzbrötchen,462,12495,6777,5718,07.06.2023
Habenshausen,Bumi,532,18423,9484,8939,22.09.2023
Hulsberg,Nougasant,317,17707,7759,9948,19.12.2023
Neuekirchen,Bumi,302,15439,7016,8423,06.06.2023
Brothalle,Nougasant,537,20865,8659,12206,28.04.2023
Brothalle,Weltmeisterbrötchen,305,15371,7480,7891,22.11.2023
Habenshausen,Knüsperbrötchen,405,14105,7932,6173,30.07.2023
Achim,Weltmeisterbrötchen,419,17475,8903,8572,01.10.2023
Neuekirchen,Bumi,497,16100,8968,7132,04.05.2023
Habenshausen,Weltmeisterbrötchen,334,17763,6045,11718,21.11.2023
Hulsberg,Nougasant,539,18482,6425,12057,13.10.2023
Brothalle,Bumi,608,19280,7421,11859,06.05.2023
Hulsberg,Weltmeisterbrötchen,427,13789,6228,7561,19.07.2023
Achim,Nougasant,465,14747,6521,8226,28.09.2023
Hulsberg,Bumi,427,17636,7207,10429,14.05.2023
Neuekirchen,Nougasant,351,15459,7788,7671,07.06.2023
Brothalle,Weltmeisterbrötchen,500,13998,9579,4419,29.05.2023
Ostertor,Kässecroissant,470,15675,7068,8607,06.03.2023
Hulsberg,Weltmeisterbrötchen,357,14426,6475,7951,22.08.2023
Ostertor,Kässecroissant,601,18659,6399,12260,11.03.2023
Hulsberg,Nougasant,565,18801,8996,9805,10.03.2023
Achim,Bumi,662,20320,8840,11480,28.07.2023
Neuekirchen,Bumi,460,14264,9247,5017,06.06.2023
Brothalle,Nougasant,660,18853,7674,11179,26.08.2023
Hulsberg,Weltmeisterbrötchen,581,20959,7980,12979,16.12.2023
Ostertor,Nougasant,496,13079,6974,6105,28.06.2023
Hulsberg,Weltmeisterbrötchen,370,16266,6306,9960,14.09.2023
Hulsberg,Weltmeisterbrötchen,333,15410,6023,9387,26.10.2023
Ostertor,Nougasant,313,13127,6000,7127,06.12.2023
Brothalle,Weltmeisterbrötchen,646,18809,6281,12528,28.04.2023
Neuekirchen,Weltmeisterbrötchen,365,15280,6258,9022,03.09.2023
Habenshausen,Kässecroissant,556,18614,8795,9819,20.01.2023
Hulsberg,Weltmeisterbrötchen,543,18592,7212,11380,17.02.2023
Hulsberg,Bumi,302,13168,6417,6751,07.08.2023
Hulsberg,Nougasant,649,18442,9036,9406,14.07.2023
Brothalle,Bumi,377,13376,8283,5093,26.09.2023
Hulsberg,Dinkelmalzbrötchen,325,15935,7206,8729,03.08.2023
Brothalle,Weltmeisterbrötchen,458,17365,6282,11083,03.08.2023
Brothalle,Bumi,631,19601,7139,12462,25.11.2023
Neuekirchen,Nougasant,494,12394,8282,4112,26.06.2023
Ostertor,Nougasant,302,16801,7701,9100,27.12.2023
Neuekirchen,Bumi,456,15042,9214,5828,12.11.2023
Brothalle,Weltmeisterbrötchen,460,13200,6097,7103,07.03.2023
Achim,Dinkelmalzbrötchen,651,20541,9571,10970,18.02.2023
Achim,Dinkelmalzbrötchen,436,12238,8866,3372,22.06.2023
Brothalle,Bumi,399,13423,6904,6519,15.01.2023
Brothalle,Knüsperbrötchen,669,20570,9582,10988,12.08.2023
Ostertor,Bumi,368,13095,9832,3263,12.01.2023
Neuekirchen,Bumi,432,16991,7402,9589,05.01.2023
Brothalle,Nougasant,561,20238,7590,12648,10.06.2023
Habenshausen,Nougasant,684,18169,8906,9263,25.11.2023
Neuekirchen,Nougasant,693,20328,9917,10411,05.05.2023
Hulsberg,Dinkelmalzbrötchen,688,18751,7781,10970,08.07.2023
Neuekirchen,Bumi,692,18431,6593,11838,21.04.2023
Ostertor,Bumi,393,14079,8536,5543,18.04.2023
Achim,Bumi,406,17953,9021,8932,17.04.2023
Brothalle,Kässecroissant,416,14203,6659,7544,19.01.2023
Hulsberg,Knüsperbrötchen,367,17711,9143,8568,25.04.2023
Achim,Bumi,312,13156,9983,3173,18.05.2023
Ostertor,Nougasant,335,13515,8424,5091,15.03.2023
Neuekirchen,Knüsperbrötchen,397,15895,9602,6293,25.07.2023
Brothalle,Kässecroissant,358,16039,9406,6633,21.12.2023
Neuekirchen,Weltmeisterbrötchen,525,18103,6744,11359,15.12.2023
Neuekirchen,Dinkelmalzbrötchen,309,17753,7286,10467,28.02.2023
Hulsberg,Nougasant,341,16511,8880,7631,03.09.2023
Hulsberg,Bumi,412,12477,6336,6141,24.09.2023
Hulsberg,Knüsperbrötchen,607,18530,7063,11467,08.04.2023
Neuekirchen,Weltmeisterbrötchen,501,19247,7899,11348,22.12.2023
Achim,Weltmeisterbrötchen,628,18767,7577,11190,31.03.2023
Hulsberg,Kässecroissant,700,18056,7710,10346,30.09.2023
Ostertor,Nougasant,492,14985,9553,5432,05.04.2023
Neuekirchen,Knüsperbrötchen,404,13844,6554,7290,12.07.2023
Habenshausen,Weltmeisterbrötchen,665,20767,9253,11514,11.11.2023
Neuekirchen,Weltmeisterbrötchen,364,12908,9880,3028,22.02.2023
Ostertor,Bumi,686,20538,7054,13484,22.12.2023
Hulsberg,Bumi,426,14729,9287,5442,03.10.2023
Hulsberg,Kässecroissant,438,15777,6293,9484,14.12.2023
Ostertor,Weltmeisterbrötchen,386,13337,8172,5165,10.09.2023
Achim,Nougasant,324,12532,8689,3843,16.05.2023
Habenshausen,Bumi,545,20169,6715,13454,07.10.2023
Brothalle,Bumi,637,20772,6777,13995,04.02.2023
Achim,Weltmeisterbrötchen,355,17567,9788,7779,02.04.2023
Hulsberg,Nougasant,335,14189,7595,6594,17.07.2023
Brothalle,Weltmeisterbrötchen,341,14589,6465,8124,05.11.2023
Brothalle,Knüsperbrötchen,423,14171,9416,4755,19.09.2023
Ostertor,Knüsperbrötchen,468,14102,7053,7049,28.08.2023
Neuekirchen,Bumi,304,15025,9879,5146,16.01.2023
Habenshausen,Nougasant,316,14533,6134,8399,22.08.2023
Brothalle,Nougasant,655,18448,7353,11095,07.04.2023
Brothalle,Weltmeisterbrötchen,462,12255,9710,2545,17.08.2023
Neuekirchen,Bumi,387,13751,7730,6021,14.05.2023
Achim,Weltmeisterbrötchen,604,19718,7887,11831,22.07.2023
Neuekirchen,Nougasant,472,12796,9852,2944,16.07.2023
Brothalle,Bumi,601,20129,8124,12005,21.10.2023
Ostertor,Nougasant,527,19609,7271,12338,09.12.2023
Neuekirchen,Weltmeisterbrötchen,444,14826,9938,4888,29.08.2023
Achim,Dinkelmalzbrötchen,653,19635,9088,10547,08.05.2023
Neuekirchen,Bumi,556,20302,8138,12164,17.03.2023
Brothalle,Dinkelmalzbrötchen,450,14489,8864,5625,09.08.2023
Ostertor,Weltmeisterbrötchen,646,19290,6875,12415,21.07.2023
Habenshausen,Nougasant,442,16303,9188,7115,09.08.2023
Habenshausen,Bumi,317,14806,8843,5963,08.03.2023
Neuekirchen,Kässecroissant,533,19019,6683,12336,12.08.2023
Ostertor,Weltmeisterbrötchen,316,15576,7262,8314,29.11.2023
Achim,Knüsperbrötchen,534,18185,6197,11988,04.03.2023
Habenshausen,Nougasant,678,20740,7522,13218,08.09.2023
Neuekirchen,Bumi,301,17177,6699,10478,07.05.2023
Habenshausen,Weltmeisterbrötchen,474,15117,7777,7340,23.07.2023
Hulsberg,Dinkelmalzbrötchen,300,12753,8363,4390,06.09.2023
Brothalle,Weltmeisterbrötchen,466,17060,6688,10372,09.08.2023
Habenshausen,Nougasant,440,17439,9171,8268,22.02.2023
Ostertor,Weltmeisterbrötchen,330,17403,8698,8705,08.11.2023
Brothalle,Knüsperbrötchen,430,14878,8433,6445,30.11.2023
Ostertor,Weltmeisterbrötchen,538,19032,6119,12913,04.03.2023
Ostertor,Dinkelmalzbrötchen,629,20368,8411,11957,03.11.2023
Habenshausen,Nougasant,364,14054,8723,5331,17.12.2023
Neuekirchen,Bumi,326,12339,8336,4003,28.08.2023
Brothalle,Nougasant,434,16594,9711,6883,28.11.2023
Achim,Knüsperbrötchen,331,15343,6461,8882,01.03.2023
Brothalle,Nougasant,404,15691,9500,6191,13.03.2023
Hulsberg,Weltmeisterbrötchen,321,14414,7812,6602,26.06.2023
Habenshausen,Knüsperbrötchen,370,14409,7495,6914,13.09.2023
Brothalle,Nougasant,429,15147,7496,7651,29.10.2023
Brothalle,Bumi,526,18565,7011,11554,29.12.2023
Ostertor,Kässecroissant,459,12994,6607,6387,11.10.2023
Brothalle,Weltmeisterbrötchen,318,13183,7137,6046,21.09.2023
Habenshausen,Weltmeisterbrötchen,456,14115,9355,4760,23.11.2023
Hulsberg,Bumi,539,19048,6779,12269,09.09.2023
Habenshausen,Bumi,618,19275,9845,9430,05.08.2023
Habenshausen,Dinkelmalzbrötchen,428,17887,8989,8898,13.03.2023
Ostertor,Weltmeisterbrötchen,342,17093,6204,10889,21.09.2023
Achim,Bumi,430,16614,8340,8274,15.01.2023
Brothalle,Bumi,405,12553,6217,6336,22.05.2023
Habenshausen,Nougasant,469,14046,9210,4836,03.05.2023
Achim,Kässecroissant,590,20374,6526,13848,20.01.2023
Hulsberg,Bumi,411,15423,9086,6337,27.08.2023
Brothalle,Nougasant,446,12764,6037,6727,12.10.2023
Hulsberg,Knüsperbrötchen,671,19822,9012,10810,29.07.2023
Neuekirchen,Weltmeisterbrötchen,475,13682,7089,6593,01.08.2023
Ostertor,Weltmeisterbrötchen,450,17982,7445,10537,29.03.2023
Achim,Bumi,615,20331,8768,11563,07.01.2023
Hulsberg,Kässecroissant,365,13984,7671,6313,30.08.2023
Neuekirchen,Nougasant,394,14896,7871,7025,31.01.2023
Brothalle,Nougasant,409,13864,7576,6288,30.07.2023
Habenshausen,Nougasant,411,14634,8611,6023,21.11.2023
Habenshausen,Weltmeisterbrötchen,487,15819,9217,6602,08.11.2023
Habenshausen,Kässecroissant,309,13293,9936,3357,03.01.2023
Hulsberg,Nougasant,330,15897,9723,6174,17.08.2023
Brothalle,Bumi,463,13888,7524,6364,24.05.2023
Ostertor,Bumi,615,20182,9369,10813,19.05.2023
Ostertor,Weltmeisterbrötchen,478,16916,7991,8925,26.06.2023
Hulsberg,Bumi,524,20199,9182,11017,16.12.2023
Hulsberg,Bumi,364,13060,9494,3566,28.03.2023
Hulsberg,Bumi,354,17764,6974,10790,02.07.2023
Ostertor,Nougasant,353,14508,6923,7585,26.07.2023
Habenshausen,Weltmeisterbrötchen,362,14760,9609,5151,06.12.2023
Achim,Bumi,305,15084,9517,5567,08.03.2023
Habenshausen,Knüsperbrötchen,486,12823,9748,3075,05.12.2023
Hulsberg,Nougasant,315,17053,7033,10020,29.11.2023
Neuekirchen,Nougasant,457,15481,9634,5847,17.05.2023
Ostertor,Bumi,477,13176,8936,4240,07.11.2023
Brothalle,Dinkelmalzbrötchen,314,14423,7793,6630,20.11.2023
Hulsberg,Knüsperbrötchen,612,18151,7500,10651,17.03.2023
Habenshausen,Kässecroissant,338,13219,6826,6393,05.12.2023
Ostertor,Knüsperbrötchen,700,18979,9145,9834,15.09.2023
Hulsberg,Weltmeisterbrötchen,591,20400,6788,13612,12.08.2023
Brothalle,Weltmeisterbrötchen,312,16594,6818,9776,01.06.2023
Hulsberg,Knüsperbrötchen,411,14347,8675,5672,30.08.2023
Brothalle,Weltmeisterbrötchen,373,13582,7995,5587,07.11.2023
Brothalle,Kässecroissant,598,18392,7351,11041,10.11.2023
Habenshausen,Bumi,481,15179,8257,6922,24.10.2023
Achim,Weltmeisterbrötchen,501,18149,8064,10085,14.04.2023
Hulsberg,Knüsperbrötchen,603,20390,6155,14235,29.09.2023
Neuekirchen,Weltmeisterbrötchen,398,16188,8771,7417,07.11.2023
Achim,Kässecroissant,322,16192,7865,8327,16.02.2023
Habenshausen,Dinkelmalzbrötchen,482,15745,7381,8364,25.09.2023
Neuekirchen,Bumi,332,12141,8509,3632,07.11.2023
Achim,Bumi,332,14228,7044,7184,27.06.2023
Ostertor,Bumi,461,15503,6168,9335,21.08.2023
Hulsberg,Kässecroissant,499,12643,7417,5226,27.08.2023
Neuekirchen,Nougasant,312,13993,9189,4804,05.10.2023
Brothalle,Weltmeisterbrötchen,346,14671,8475,6196,26.02.2023
Neuekirchen,Weltmeisterbrötchen,469,16564,9398,7166,11.10.2023
Achim,Nougasant,387,14291,7272,7019,22.06.2023
Neuekirchen,Nougasant,430,15989,7388,8601,26.09.2023
Habenshausen,Dinkelmalzbrötchen,418,16812,9725,7087,23.10.2023
Brothalle,Knüsperbrötchen,658,18567,7838,10729,03.11.2023
Hulsberg,Bumi,433,16122,9606,6516,26.11.2023
Habenshausen,Bumi,323,13474,7832,5642,01.05.2023
Achim,Dinkelmalzbrötchen,497,14141,8413,5728,09.05.2023
Ostertor,Bumi,346,14789,6635,8154,16.11.2023
Habenshausen,Nougasant,372,12899,6475,6424,13.11.2023
Brothalle,Nougasant,303,15026,6773,8253,14.02.2023
Ostertor,Weltmeisterbrötchen,437,14117,6768,7349,02.04.2023
Ostertor,Nougasant,417,12248,9785,2463,10.04.2023
Hulsberg,Nougasant,487,13155,6503,6652,27.03.2023
Neuekirchen,Weltmeisterbrötchen,409,15022,7411,7611,05.07.2023
Hulsberg,Bumi,314,16673,6079,10594,12.10.2023
Habenshausen,Bumi,475,16118,9501,6617,06.03.2023
Neuekirchen,Bumi,301,15538,9548,5990,13.09.2023
Habenshausen,Bumi,471,13283,9481,3802,26.12.2023
Neuekirchen,Dinkelmalzbrötchen,307,15856,9202,6654,19.11.2023
Brothalle,Weltmeisterbrötchen,429,12947,7446,5501,16.02.2023
Ostertor,Kässecroissant,449,13015,6105,6910,06.09.2023
Habenshausen,Nougasant,631,19211,9028,10183,07.07.2023
Ostertor,Dinkelmalzbrötchen,675,19690,7856,11834,15.04.2023
Ostertor,Nougasant,555,20068,6754,13314,10.06.2023
Neuekirchen,Bumi,340,16650,9544,7106,12.07.2023
Brothalle,Nougasant,341,17394,9623,7771,11.12.2023
Hulsberg,Knüsperbrötchen,452,12813,9382,3431,05.11.2023
Brothalle,Dinkelmalzbrötchen,403,17117,9674,7443,24.09.2023
Achim,Bumi,661,20302,6503,13799,23.09.2023
Habenshausen,Weltmeisterbrötchen,427,14714,8415,6299,04.04.2023
Achim,Kässecroissant,619,20398,8127,12271,24.02.2023
Habenshausen,Weltmeisterbrötchen,419,17231,8264,8967,13.12.2023
Habenshausen,Nougasant,479,17779,9274,8505,15.02.2023
Brothalle,Weltmeisterbrötchen,364,15313,8944,6369,26.07.2023
Habenshausen,Knüsperbrötchen,654,18678,7493,11185,25.02.2023
Habenshausen,Weltmeisterbrötchen,566,20432,6986,13446,26.08.2023
Habenshausen,Bumi,400,14715,6593,8122,05.12.2023
Achim,Weltmeisterbrötchen,455,14114,6553,7561,04.05.2023
Brothalle,Nougasant,671,18437,9894,8543,15.12.2023
Habenshausen,Knüsperbrötchen,416,12758,9765,2993,13.09.2023
Habenshausen,Nougasant,305,14256,6914,7342,13.04.2023
Ostertor,Bumi,324,12303,6037,6266,22.10.2023
Ostertor,Nougasant,338,13629,9971,3658,17.10.2023
Habenshausen,Weltmeisterbrötchen,406,15769,9617,6152,05.10.2023
Ostertor,Bumi,332,16276,9416,6860,10.09.2023
Neuekirchen,Bumi,532,19778,9819,9959,07.01.2023
Neuekirchen,Bumi,489,12826,6310,6516,29.10.2023
Ostertor,Weltmeisterbrötchen,581,20787,9121,11666,28.04.2023
Achim,Bumi,365,17105,9080,8025,15.03.2023
Neuekirchen,Dinkelmalzbrötchen,500,14375,8737,5638,01.02.2023
Habenshausen,Dinkelmalzbrötchen,418,15185,9585,5600,25.12.2023
Hulsberg,Weltmeisterbrötchen,311,13358,8184,5174,08.08.2023
Neuekirchen,Nougasant,643,18038,7255,10783,08.05.2023
Achim,Weltmeisterbrötchen,316,15861,6190,9671,15.03.2023
Hulsberg,Bumi,600,19456,9996,9460,04.08.2023
Brothalle,Bumi,656,19271,9274,9997,08.04.2023
Neuekirchen,Nougasant,697,18690,9579,9111,10.11.2023
Habenshausen,Nougasant,396,17634,9428,8206,01.03.2023
Habenshausen,Weltmeisterbrötchen,700,19911,7022,12889,01.09.2023
Ostertor,Dinkelmalzbrötchen,470,13100,7132,5968,03.10.2023
Hulsberg,Weltmeisterbrötchen,660,20952,7837,13115,20.05.2023
Brothalle,Bumi,390,13322,7739,5583,05.06.2023
Hulsberg,Bumi,350,17242,7724,9518,28.05.2023
Neuekirchen,Kässecroissant,507,18921,8241,10680,22.09.2023
Brothalle,Bumi,679,19187,9096,10091,04.11.2023
Ostertor,Weltmeisterbrötchen,509,19913,8165,11748,26.05.2023
Achim,Kässecroissant,502,18699,9039,9660,05.08.2023
Achim,Knüsperbrötchen,476,15534,7218,8316,11.10.2023
Hulsberg,Weltmeisterbrötchen,469,16400,9587,6813,18.07.2023
Achim,Knüsperbrötchen,322,14018,6516,7502,06.08.2023
Ostertor,Bumi,405,13472,7273,6199,27.09.2023
Neuekirchen,Bumi,566,19054,6267,12787,27.10.2023
Habenshausen,Nougasant,301,17126,8657,8469,22.03.2023
Hulsberg,Bumi,496,13670,9495,4175,14.03.2023
Hulsberg,Nougasant,557,20674,8446,12228,25.02.2023
Ostertor,Weltmeisterbrötchen,321,17846,6945,10901,02.01.2023
Achim,Bumi,443,14615,7746,6869,19.10.2023
Habenshausen,Kässecroissant,587,19105,6629,12476,05.08.2023
Achim,Weltmeisterbrötchen,358,17528,7897,9631,31.07.2023
Brothalle,Nougasant,531,19957,6852,13105,15.07.2023
Neuekirchen,Dinkelmalzbrötchen,439,16910,8556,8354,27.06.2023
Neuekirchen,Kässecroissant,414,14380,6853,7527,23.03.2023
Ostertor,Nougasant,492,13008,8870,4138,20.09.2023
Achim,Weltmeisterbrötchen,692,20743,6974,13769,20.10.2023
Ostertor,Kässecroissant,359,17222,6343,10879,19.12.2023
Brothalle,Nougasant,484,16307,8543,7764,07.11.2023
Habenshausen,Dinkelmalzbrötchen,371,14818,8472,6346,14.08.2023
Brothalle,Nougasant,359,17104,7584,9520,21.12.2023
Hulsberg,Nougasant,455,13191,9642,3549,28.06.2023
Achim,Nougasant,312,12908,8072,4836,07.11.2023
Habenshausen,Weltmeisterbrötchen,503,19053,9020,10033,31.03.2023
Achim,Nougasant,392,13833,6677,7156,03.12.2023
Ostertor,Weltmeisterbrötchen,360,14053,9710,4343,29.11.2023
Neuekirchen,Kässecroissant,542,19452,7249,12203,13.01.2023
Habenshausen,Bumi,407,17919,6479,11440,20.02.2023
Neuekirchen,Dinkelmalzbrötchen,334,17107,9856,7251,31.05.2023
Neuekirchen,Nougasant,698,20669,6305,14364,28.07.2023
Brothalle,Nougasant,462,15477,8779,6698,02.08.2023
Ostertor,Bumi,457,17174,8534,8640,29.11.2023
Ostertor,Nougasant,305,16343,8795,7548,12.03.2023
Hulsberg,Weltmeisterbrötchen,325,17499,7662,9837,09.05.2023
Brothalle,Bumi,385,13528,9543,3985,06.04.2023
Brothalle,Nougasant,395,12943,8270,4673,26.09.2023
Ostertor,Weltmeisterbrötchen,350,15346,8742,6604,13.03.2023
Achim,Bumi,517,18310,6165,12145,11.08.2023
Neuekirchen,Dinkelmalzbrötchen,374,14774,9450,5324,08.06.2023
Brothalle,Weltmeisterbrötchen,546,19401,7794,11607,17.11.2023
Brothalle,Knüsperbrötchen,381,15102,6407,8695,06.02.2023
Brothalle,Weltmeisterbrötchen,502,18642,6157,12485,14.01.2023
Habenshausen,Nougasant,670,20398,6713,13685,15.12.2023
Ostertor,Bumi,422,12611,8242,4369,11.07.2023
Brothalle,Nougasant,549,18174,9148,9026,02.09.2023
Habenshausen,Dinkelmalzbrötchen,342,14125,6457,7668,11.01.2023
Ostertor,Kässecroissant,684,18941,7844,11097,04.02.2023
Brothalle,Bumi,410,15310,7455,7855,31.07.2023
Habenshausen,Weltmeisterbrötchen,468,15997,9227,6770,26.10.2023
Ostertor,Bumi,407,13661,9944,3717,29.03.2023
Brothalle,Knüsperbrötchen,341,14892,6878,8014,14.12.2023
Achim,Kässecroissant,671,20839,8279,12560,13.05.2023
Habenshausen,Nougasant,379,12899,6229,6670,24.05.2023
Ostertor,Weltmeisterbrötchen,404,15223,8550,6673,09.08.2023
Ostertor,Weltmeisterbrötchen,498,14161,9065,5096,29.11.2023
Neuekirchen,Knüsperbrötchen,468,16222,7552,8670,07.03.2023
Hulsberg,Weltmeisterbrötchen,426,13186,7355,5831,14.12.2023
Hulsberg,Nougasant,489,12849,9755,3094,01.06.2023
Habenshausen,Nougasant,341,14931,7281,7650,20.03.2023
Ostertor,Weltmeisterbrötchen,383,13098,7633,5465,05.04.2023
Brothalle,Weltmeisterbrötchen,428,16488,9271,7217,14.05.2023
Habenshausen,Bumi,412,13124,9783,3341,23.01.2023
Habenshausen,Knüsperbrötchen,375,12722,6088,6634,01.10.2023
Ostertor,Knüsperbrötchen,527,18115,8467,9648,29.12.2023
Habenshausen,Nougasant,627,19955,8988,10967,18.03.2023
Hulsberg,Bumi,496,14304,6424,7880,07.06.2023
Neuekirchen,Weltmeisterbrötchen,362,12641,9134,3507,31.10.2023
Neuekirchen,Weltmeisterbrötchen,647,20499,9369,11130,21.07.2023
Neuekirchen,Bumi,536,18766,7709,11057,22.09.2023
Achim,Kässecroissant,476,14775,9113,5662,23.05.2023
Brothalle,Nougasant,631,19832,6228,13604,23.12.2023
Ostertor,Weltmeisterbrötchen,357,13162,9102,4060,30.05.2023
Ostertor,Knüsperbrötchen,618,20898,7136,13762,26.08.2023
Ostertor,Dinkelmalzbrötchen,319,15836,6016,9820,01.03.2023
Habenshausen,Nougasant,609,20872,9404,11468,15.12.2023
Hulsberg,Dinkelmalzbrötchen,334,15414,9184,6230,02.08.2023
Hulsberg,Nougasant,467,15100,8069,7031,17.04.2023
Brothalle,Bumi,478,15895,7614,8281,08.08.2023
Brothalle,Weltmeisterbrötchen,583,18743,6422,12321,12.05.2023
Neuekirchen,Bumi,458,13084,7648,5436,21.05.2023
Neuekirchen,Dinkelmalzbrötchen,515,20780,7234,13546,13.05.2023
Neuekirchen,Knüsperbrötchen,346,14110,6384,7726,27.08.2023
Hulsberg,Bumi,425,13907,9578,4329,23.03.2023
Brothalle,Weltmeisterbrötchen,457,16630,6810,9820,07.03.2023
Neuekirchen,Bumi,555,19925,6018,13907,06.10.2023
Brothalle,Knüsperbrötchen,444,16873,6991,9882,10.01.2023
Habenshausen,Knüsperbrötchen,326,16615,9783,6832,04.06.2023
Brothalle,Nougasant,448,12187,8777,3410,20.07.2023
Neuekirchen,Weltmeisterbrötchen,322,13548,8168,5380,13.04.2023
Ostertor,Weltmeisterbrötchen,561,18538,6869,11669,06.10.2023
Achim,Nougasant,365,16246,6849,9397,09.10.2023
Achim,Weltmeisterbrötchen,342,15998,9282,6716,12.02.2023
Hulsberg,Nougasant,483,12118,8490,3628,03.04.2023
Neuekirchen,Nougasant,302,17018,7319,9699,27.12.2023
Brothalle,Dinkelmalzbrötchen,483,13499,7018,6481,28.06.2023
Habenshausen,Weltmeisterbrötchen,370,14405,7851,6554,25.09.2023
Hulsberg,Bumi,309,12309,8222,4087,19.01.2023
Achim,Weltmeisterbrötchen,650,18019,9647,8372,11.11.2023
Hulsberg,Nougasant,450,16260,7566,8694,21.11.2023
Neuekirchen,Bumi,579,18112,7537,10575,30.09.2023
Achim,Weltmeisterbrötchen,332,16594,6422,10172,17.08.2023
Brothalle,Bumi,434,17840,6271,11569,08.01.2023
Achim,Knüsperbrötchen,485,14371,8069,6302,26.03.2023
Achim,Nougasant,325,17635,8848,8787,21.11.2023
Neuekirchen,Nougasant,306,14512,6436,8076,03.05.2023
Brothalle,Kässecroissant,367,15791,7004,8787,07.02.2023
Achim,Weltmeisterbrötchen,480,12016,8831,3185,08.10.2023
Brothalle,Nougasant,668,18273,9176,9097,26.08.2023
Ostertor,Weltmeisterbrötchen,398,15136,6136,9000,22.11.2023
Hulsberg,Knüsperbrötchen,305,12107,9697,2410,19.11.2023
Neuekirchen,Weltmeisterbrötchen,428,17469,9821,7648,22.01.2023
Neuekirchen,Bumi,485,13846,6701,7145,04.09.2023
Hulsberg,Weltmeisterbrötchen,518,19505,6810,12695,15.04.2023
Achim,Dinkelmalzbrötchen,305,13879,9831,4048,23.11.2023
Ostertor,Dinkelmalzbrötchen,489,13101,8472,4629,16.08.2023
Neuekirchen,Nougasant,439,15595,7056,8539,05.02.2023
Neuekirchen,Nougasant,537,19954,7347,12607,01.09.2023
Habenshausen,Nougasant,527,20013,9160,10853,02.09.2023
Achim,Kässecroissant,611,18134,6256,11878,23.06.2023
Brothalle,Knüsperbrötchen,413,12301,9015,3286,05.01.2023
Ostertor,Bumi,439,12844,7787,5057,30.01.2023
Achim,Weltmeisterbrötchen,359,17793,6074,11719,08.10.2023
Neuekirchen,Nougasant,614,19438,9954,9484,28.01.2023
Hulsberg,Bumi,638,19246,9916,9330,01.04.2023
Neuekirchen,Weltmeisterbrötchen,405,12764,8379,4385,20.06.2023
Hulsberg,Weltmeisterbrötchen,450,14842,8591,6251,09.05.2023
Ostertor,Weltmeisterbrötchen,363,12174,8300,3874,31.05.2023
Neuekirchen,Bumi,341,15882,8289,7593,23.10.2023
Hulsberg,Knüsperbrötchen,522,20347,7401,12946,01.04.2023
Brothalle,Dinkelmalzbrötchen,498,13929,8411,5518,11.12.2023
Brothalle,Dinkelmalzbrötchen,498,17828,6397,11431,22.02.2023
Habenshausen,Dinkelmalzbrötchen,436,17404,7976,9428,01.10.2023
Hulsberg,Nougasant,412,17726,9096,8630,04.07.2023
Neuekirchen,Bumi,428,12275,6784,5491,05.09.2023
Neuekirchen,Weltmeisterbrötchen,336,17051,8248,8803,26.04.2023
Hulsberg,Nougasant,423,17744,8451,9293,14.06.2023
Habenshausen,Kässecroissant,402,17991,9224,8767,10.12.2023
Habenshausen,Bumi,333,14588,6806,7782,19.10.2023
Neuekirchen,Weltmeisterbrötchen,449,14066,8435,5631,13.09.2023
Hulsberg,Nougasant,307,14199,7408,6791,19.02.2023
Ostertor,Nougasant,553,18740,6116,12624,11.11.2023
Ostertor,Nougasant,354,16580,8286,8294,02.07.2023
Hulsberg,Knüsperbrötchen,623,19691,8437,11254,11.11.2023
Ostertor,Kässecroissant,587,20671,6975,13696,30.10.2023
Habenshausen,Bumi,501,20420,7050,13370,15.07.2023
Hulsberg,Weltmeisterbrötchen,521,18511,9892,8619,27.01.2023
Neuekirchen,Nougasant,419,12125,7074,5051,23.01.2023
Achim,Weltmeisterbrötchen,684,20975,9060,11915,04.03.2023
Habenshausen,Knüsperbrötchen,452,17584,9252,8332,25.12.2023
Neuekirchen,Weltmeisterbrötchen,667,18445,6715,11730,15.07.2023
Brothalle,Weltmeisterbrötchen,648,19739,7978,11761,09.06.2023
Ostertor,Knüsperbrötchen,442,15186,6034,9152,13.11.2023
Brothalle,Knüsperbrötchen,415,17729,6867,10862,28.09.2023
Achim,Bumi,511,18838,6672,12166,06.10.2023
Brothalle,Bumi,606,18796,9230,9566,14.07.2023
Ostertor,Bumi,372,14995,8807,6188,12.11.2023
Ostertor,Knüsperbrötchen,396,15617,7020,8597,11.07.2023
Hulsberg,Nougasant,396,16959,8953,8006,17.09.2023
Brothalle,Weltmeisterbrötchen,459,13547,7350,6197,07.05.2023
Ostertor,Bumi,491,12894,6125,6769,26.06.2023
Ostertor,Nougasant,431,16942,6701,10241,31.08.2023
Neuekirchen,Nougasant,416,14649,9844,4805,08.02.2023
Hulsberg,Bumi,575,20190,9068,11122,17.03.2023
Hulsberg,Kässecroissant,339,14695,9916,4779,14.08.2023
Neuekirchen,Weltmeisterbrötchen,380,15240,7734,7506,30.03.2023
Neuekirchen,Weltmeisterbrötchen,674,19637,8744,10893,29.12.2023
Habenshausen,Bumi,412,17647,8085,9562,23.03.2023
Habenshausen,Bumi,477,12756,9044,3712,03.10.2023
Hulsberg,Bumi,336,12895,7073,5822,15.08.2023
Hulsberg,Knüsperbrötchen,485,14274,8963,5311,01.06.2023
Habenshausen,Bumi,479,17620,6917,10703,14.05.2023
Achim,Bumi,448,12773,9379,3394,31.01.2023
Brothalle,Bumi,337,16647,8991,7656,17.07.2023
Ostertor,Nougasant,491,13083,8196,4887,01.10.2023
Neuekirchen,Dinkelmalzbrötchen,319,12239,6557,5682,08.08.2023
Hulsberg,Kässecroissant,388,13694,6838,6856,09.05.2023
Achim,Bumi,379,13778,6593,7185,17.01.2023
Brothalle,Nougasant,470,17603,7503,10100,22.02.2023
Brothalle,Knüsperbrötchen,697,18757,9258,9499,04.02.2023
Habenshausen,Knüsperbrötchen,398,14019,9094,4925,01.06.2023
Achim,Bumi,334,13555,7410,6145,19.10.2023
Neuekirchen,Weltmeisterbrötchen,374,14288,9501,4787,26.01.2023
Achim,Nougasant,466,17026,9343,7683,15.11.2023
Brothalle,Bumi,418,13966,7019,6947,01.06.2023
Habenshausen,Weltmeisterbrötchen,379,14977,6149,8828,12.03.2023
Hulsberg,Bumi,568,19401,8788,10613,04.08.2023
Neuekirchen,Bumi,605,18696,6682,12014,05.08.2023
Neuekirchen,Bumi,602,19993,7286,12707,04.02.2023
Achim,Bumi,376,14122,6446,7676,24.09.2023
Ostertor,Nougasant,424,15361,8288,7073,20.11.2023
Ostertor,Bumi,419,12700,8982,3718,12.02.2023
Ostertor,Knüsperbrötchen,403,12907,8547,4360,25.09.2023
Hulsberg,Nougasant,359,17767,9099,8668,15.01.2023
Achim,Knüsperbrötchen,501,20880,8527,12353,25.03.2023
Brothalle,Kässecroissant,455,16709,8030,8679,25.07.2023
Neuekirchen,Bumi,489,16489,6640,9849,25.10.2023
Neuekirchen,Kässecroissant,394,13446,6381,7065,26.04.2023
Neuekirchen,Weltmeisterbrötchen,318,12868,6753,6115,14.12.2023
Hulsberg,Nougasant,465,16679,8607,8072,15.11.2023
Ostertor,Nougasant,432,15392,7334,8058,14.03.2023
Hulsberg,Weltmeisterbrötchen,645,20906,8182,12724,30.06.2023
Brothalle,Nougasant,560,18205,9090,9115,31.03.2023
Achim,Bumi,371,17945,6778,11167,11.01.2023
Hulsberg,Knüsperbrötchen,320,16754,6897,9857,08.03.2023
Achim,Nougasant,420,15635,6370,9265,27.12.2023
Hulsberg,Dinkelmalzbrötchen,700,18195,9800,8395,14.10.2023
Habenshausen,Kässecroissant,409,13012,8119,4893,01.03.2023
Brothalle,Weltmeisterbrötchen,352,17176,7253,9923,23.04.2023
Achim,Nougasant,529,20006,6133,13873,08.04.2023
Neuekirchen,Bumi,459,16348,7086,9262,07.09.2023
Achim,Dinkelmalzbrötchen,460,14320,7785,6535,20.03.2023
Habenshausen,Nougasant,369,12665,6969,5696,26.03.2023
Habenshausen,Weltmeisterbrötchen,547,20005,6421,13584,24.12.2023
Ostertor,Nougasant,541,19883,9662,10221,28.10.2023
Neuekirchen,Weltmeisterbrötchen,453,15746,9439,6307,17.10.2023
Ostertor,Weltmeisterbrötchen,473,17129,7576,9553,24.08.2023
Neuekirchen,Bumi,369,13811,8149,5662,10.07.2023
Brothalle,Nougasant,444,13750,8743,5007,31.01.2023
Achim,Nougasant,381,12385,9917,2468,16.11.2023
Hulsberg,Kässecroissant,351,13956,7903,6053,12.01.2023
Brothalle,Nougasant,318,12038,7835,4203,02.08.2023
Habenshausen,Weltmeisterbrötchen,488,14065,8358,5707,18.12.2023
Hulsberg,Bumi,395,15696,7417,8279,12.04.2023
Ostertor,Kässecroissant,420,12661,6815,5846,21.02.2023
Hulsberg,Bumi,312,16053,6448,9605,27.07.2023
Achim,Kässecroissant,632,20172,9241,10931,16.09.2023
Hulsberg,Kässecroissant,334,16978,6106,10872,21.06.2023
Neuekirchen,Bumi,498,12113,9069,3044,08.06.2023
Brothalle,Bumi,449,16805,9264,7541,05.04.2023
Ostertor,Weltmeisterbrötchen,468,16153,8072,8081,02.11.2023
Ostertor,Bumi,551,20250,8412,11838,22.04.2023
Brothalle,Weltmeisterbrötchen,301,16214,7325,8889,04.07.2023
Achim,Weltmeisterbrötchen,420,17695,6345,11350,23.01.2023
Habenshausen,Bumi,465,15679,6722,8957,12.04.2023
Hulsberg,Dinkelmalzbrötchen,559,20097,8567,11530,11.11.2023
Brothalle,Bumi,507,18238,9191,9047,27.05.2023
Hulsberg,Nougasant,308,12749,7129,5620,14.11.2023
